amkamlo	అంకంలో	అంకంలో
ankamlo	కాచె	అంకంలో
ankamloo	అంకంలో	అంకంలో
amkitamai	దాకా	అంకితమై
ankitamai	తోదా	అంకితమై
ankela	కా	అంకెల
ankelanu	దాదా	అంకెలను
angeekarinchaka	అంగీకరించక	అంగీకరించక
amgiikarimchaadu	జునోచెలే	అంగీకరించాడు
angeekarinchaadu	జులేవిరు	అంగీకరించాడు
angiikarinchaadu	తోనోతోచె	అంగీకరించాడు
angeekarinchaali	దానోపిపి	అంగీకరించాలి
angikarinchaali	అంగీకరించాలి	అంగీకరించాలి
angeekarinchi	రునోదా	అంగీకరించి
angikarinchi	పిదారు	అంగీకరించి
angeekarimchina	అంగీకరించిన	అంగీకరించిన
angeekarinchina	అంగీకరించిన	అంగీకరించిన
angeekarinche	పిదారు	అంగీకరించే
angikarinchay	అంగీకరించే	అంగీకరించే
angikarinche	అంగీకరించే	అంగీకరించే
antaarani	లేలే	అంటారని
antarani	అంటారని	అంటారని
antaavaa	పిరు	అంటావా
antava	పిపి	అంటావా
andar	అండర్	అండర్
ander	లే	అండర్
undar	అండర్	అండర్
under	కా	అండర్
amtagaa	అంతగా	అంతగా
antagaa	లే	అంతగా
anthagaa	అంతగా	అంతగా
antamavutondi	కాకాజు	అంతమవుతుంది
antamavutundi	అంతమవుతుంది	అంతమవుతుంది
anthamavuthondi	అంతమవుతుంది	అంతమవుతుంది
anthamavuthundhi	నోరురు	అంతమవుతుంది
amtaloenae	జులే	అంతలోనే
anthalone	పిదా	అంతలోనే
anthaloonee	అంతలోనే	అంతలోనే
amtu	జు	అంతు
anthu	అంతు	అంతు
ampair	అంపైర్	అంపైర్
umpair	రులే	అంపైర్
umpire	అంపైర్	అంపైర్
akkineeni	నోపినో	అక్కినేని
akkineni	అక్కినేని	అక్కినేని
akrama	అక్రమ	అక్రమ
akramaalu	అక్రమాలు	అక్రమాలు
akramalu	వినో	అక్రమాలు
agni	వి	అగ్ని
agniki	కాచె	అగ్నికి
agnini	అగ్నిని	అగ్నిని
agnilo	వినో	అగ్నిలో
agniloo	దాజు	అగ్నిలో
ajeej	పి	అజీజ్
ajeez	అజీజ్	అజీజ్
ajiz	నో	అజీజ్
azeez	రు	అజీజ్
aziz	చె	అజీజ్
ajeernamu	రుకా	అజీర్ణము
ajeernhamu	అజీర్ణము	అజీర్ణము
ajirnamu	అజీర్ణము	అజీర్ణము
aghnanapu	అజ్ఞానపు	అజ్ఞానపు
agnaanapu	పిరు	అజ్ఞానపు
ajnanapu	పిదా	అజ్ఞానపు
aghnaanamu	అజ్ఞానము	అజ్ఞానము
agnaanamu	పిజు	అజ్ఞానము
ajnanamu	అజ్ఞానము	అజ్ఞానము
aghaani	అజ్ఞాని	అజ్ఞాని
agnani	రులే	అజ్ఞాని
ajnani	అజ్ఞాని	అజ్ఞాని
atlanti	అట్లాంటి	అట్లాంటి
ada	చె	అడ
adigithe	రులే	అడిగితే
aana	అణా	అణా
ana	అణా	అణా
anaa	అణా	అణా
atanoka	అతనొక	అతనొక
athanoka	తో	అతనొక
atanni	అతన్ని	అతన్ని
athanni	చెజు	అతన్ని
atul	నో	అతుల్
adi	అది	అది
adigo	అదిగో	అదిగో
adigoo	అదిగో	అదిగో
adivinna	అదివిన్న	అదివిన్న
adhupu	అదుపు	అదుపు
adupu	రు	అదుపు
adhupuloo	జుకా	అదుపులో
adupulo	అదుపులో	అదుపులో
adupuloo	దాదా	అదుపులో
adharmamgaa	పికా	అధర్మంగా
adharmanga	రునో	అధర్మంగా
adharmamu	లేవి	అధర్మము
adhikam	లే	అధికం
adhikamga	రుకా	అధికంగా
adhikanga	తోవి	అధికంగా
adhikangaa	అధికంగా	అధికంగా
adhikamuga	కాకా	అధికముగా
adhikamugaa	కాకా	అధికముగా
adhikamaina	అధికమైన	అధికమైన
adhirohinchaaru	రుతోతోకా	అధిరోహించారు
adhirohincharu	జురునోకా	అధిరోహించారు
adhiroohimchaaru	లేలేదాచె	అధిరోహించారు
addoah	చె	అధో
adho	కా	అధో
adhoh	రు	అధో
adhyakshathana	అధ్యక్షతన	అధ్యక్షతన
adhyakshthana	విచెపి	అధ్యక్షతన
adyakshathana	నోవిజు	అధ్యక్షతన
adhyayanamtho	అధ్యయనంతో	అధ్యయనంతో
adhyayanumthoo	అధ్యయనంతో	అధ్యయనంతో
adhyayanamu	అధ్యయనము	అధ్యయనము
adhyyanamu	నోదా	అధ్యయనము
ananthapuram	అనంతపురం	అనంతపురం
anatapuram	అనంతపురం	అనంతపురం
ananthapuramlo	లేపిరు	అనంతపురంలో
anakundaa	అనకుండా	అనకుండా
anakundhaa	దావి	అనకుండా
anaconda	లేతో	అనకొండ
anakonda	తోరు	అనకొండ
anatam	జు	అనటం
anane	అనని	అనని
anani	నో	అనని
ananu	అనను	అనను
anaparthi	అనపర్తి	అనపర్తి
anaparthy	చెజు	అనపర్తి
anipinchi	జువి	అనిపించి
anipinchina	దాతోపి	అనిపించిన
anipinnchina	అనిపించిన	అనిపించిన
anivaarya	తోచె	అనివార్య
anivaaryamgaa	చెకాతో	అనివార్యంగా
anivaaryamyna	రుకాపి	అనివార్యమైన
anivaryamaina	అనివార్యమైన	అనివార్యమైన
aniwaryamaina	అనివార్యమైన	అనివార్యమైన
anugunamgaa	తోకానో	అనుగుణముగా
anugunamuga	రుకాలే	అనుగుణముగా
anugunamugaa	చెజురు	అనుగుణముగా
anugunamaina	జుకాకా	అనుగుణమైన
anugunamyna	పిచెరు	అనుగుణమైన
anunadhi	జుచె	అనునది
anunadi	అనునది	అనునది
anubhuthi	పిచె	అనుభూతి
anubhuuti	అనుభూతి	అనుభూతి
anubhuthiga	అనుభూతిగా	అనుభూతిగా
anubhuutigaa	పిలేదా	అనుభూతిగా
anuraaga	రుచె	అనురాగ
anuraga	అనురాగ	అనురాగ
anuraagam	అనురాగం	అనురాగం
anuragam	చెనో	అనురాగం
anuraagaalu	అనురాగాలు	అనురాగాలు
anuragalu	అనురాగాలు	అనురాగాలు
anusaasanika	కాచెపి	అనుశాసనిక
anushasanika	కానోచె	అనుశాసనిక
anusandaanamai	అనుసంధానమై	అనుసంధానమై
anusandhaanamai	అనుసంధానమై	అనుసంధానమై
anusandhaanamy	అనుసంధానమై	అనుసంధానమై
ane	జు	అనె
ano	కా	అనో
anoo	కా	అనో
annadaanam	అన్నదానం	అన్నదానం
annadanam	అన్నదానం	అన్నదానం
annadaanamu	రుచెతో	అన్నదానము
annadanamu	పిపితో	అన్నదానము
annimtinee	చెవిరు	అన్నింటినీ
annimtinii	అన్నింటినీ	అన్నింటినీ
annintinee	రుజుపి	అన్నింటినీ
annintini	అన్నింటినీ	అన్నింటినీ
annintinii	నోచెపి	అన్నింటినీ
annividhaalaa	అన్నివిధాలా	అన్నివిధాలా
annividhala	పిదాతో	అన్నివిధాలా
anyaapadesamga	నోతోతోవి	అన్యాపదేశంగా
anyapadesamga	రురుపిలే	అన్యాపదేశంగా
anveshinchaaru	జుకానోనో	అన్వేషించారు
anveshincharu	జుకానోలే	అన్వేషించారు
anveshinche	విదాలే	అన్వేషించే
anveshisthuu	అన్వేషిస్తూ	అన్వేషిస్తూ
anveshistu	నోతోజు	అన్వేషిస్తూ
anveshistuu	అన్వేషిస్తూ	అన్వేషిస్తూ
apakeerthi	అపకీర్తి	అపకీర్తి
aparna	అపర్ణ	అపర్ణ
abaddaala	వినో	అబద్ధాల
abaddhaala	జుతో	అబద్ధాల
abaddhala	అబద్ధాల	అబద్ధాల
aabba	అబ్బా	అబ్బా
aba	అబ్బా	అబ్బా
abba	చె	అబ్బా
abbaa	చె	అబ్బా
abhimaana	లేజు	అభిమాన
abhimaanam	నోలే	అభిమానం
abhimaanamtho	అభిమానంతో	అభిమానంతో
abhimaanamthoo	అభిమానంతో	అభిమానంతో
abhimanamto	అభిమానంతో	అభిమానంతో
abhimaanaaniki	అభిమానానికి	అభిమానానికి
abhimananiki	పినోరు	అభిమానానికి
abhimaanaanni	అభిమానాన్ని	అభిమానాన్ని
abhimananni	వినోపి	అభిమానాన్ని
abhimaanulu	అభిమానులు	అభిమానులు
abhimanulu	అభిమానులు	అభిమానులు
abhimaanulugaa	తోపిజు	అభిమానులుగా
abhimanuluga	అభిమానులుగా	అభిమానులుగా
abimaanulugaa	దాచెవి	అభిమానులుగా
abhimaanulae	పిచెకా	అభిమానులే
abhimaanulee	రుతోపి	అభిమానులే
abhimanule	అభిమానులే	అభిమానులే
abhivruddhi	జుపికా	అభివృద్ధి
abhivruddhiki	అభివృద్ధికి	అభివృద్ధికి
abhivruddiki	దాతోజు	అభివృద్ధికి
abhivruddhini	అభివృద్ధిని	అభివృద్ధిని
abhivruddini	అభివృద్ధిని	అభివృద్ధిని
abhvruddhini	అభివృద్ధిని	అభివృద్ధిని
abhivruddhilo	కాకారు	అభివృద్ధిలో
abhivruddiloo	అభివృద్ధిలో	అభివృద్ధిలో
abhyunnathiki	అభ్యున్నతికి	అభ్యున్నతికి
abhyunnatiki	అభ్యున్నతికి	అభ్యున్నతికి
amarudu	అమరుడు	అమరుడు
amaanusha	దానో	అమానుష
amanusha	తోరు	అమానుష
amaayaka	చె	అమాయక
amayaka	తో	అమాయక
amaayakapu	కాదా	అమాయకపు
amayakapu	జులే	అమాయకపు
amaayakudaina	లేదాదా	అమాయకుడైన
amayakudaina	అమాయకుడైన	అమాయకుడైన
amrutamae	అమృతమే	అమృతమే
amruthame	రునో	అమృతమే
amruthamee	విపి	అమృతమే
amarican	అమెరికన్	అమెరికన్
american	దాచె	అమెరికన్
amerikan	అమెరికన్	అమెరికన్
americanla	అమెరికన్ల	అమెరికన్ల
americanlu	అమెరికన్ల	అమెరికన్ల
amerikanla	తోతోజు	అమెరికన్ల
amme	అమ్మే	అమ్మే
ammee	అమ్మే	అమ్మే
ammeevaaru	దాదాతో	అమ్మేవారు
ammevaru	కాతోదా	అమ్మేవారు
ayitene	అయితేనే	అయితేనే
ayitheenee	అయితేనే	అయితేనే
ayithene	అయితేనే	అయితేనే
ayyindi	వినో	అయ్యింది
arachaeti	చెలే	అరచేతి
aracheethi	అరచేతి	అరచేతి
aracheti	కాచె	అరచేతి
arachaetini	అరచేతిని	అరచేతిని
aracheethini	జువి	అరచేతిని
arachetini	అరచేతిని	అరచేతిని
arati	నో	అరటి
aranhyamloe	అరణ్యంలో	అరణ్యంలో
aranyamlo	పితో	అరణ్యంలో
aranyamloo	దారు	అరణ్యంలో
aranhyaalathoo	అరణ్యాలతో	అరణ్యాలతో
aranyaalatho	అరణ్యాలతో	అరణ్యాలతో
aranyalato	అరణ్యాలతో	అరణ్యాలతో
aranhyaalu	అరణ్యాలు	అరణ్యాలు
aranyaalu	చెదా	అరణ్యాలు
aranyalu	అరణ్యాలు	అరణ్యాలు
aru	చె	అరు
arjunini	వినోపి	అర్జునిని
arjununi	జులేతో	అర్జునిని
ardhamto	జులే	అర్థంతో
ardhamtoe	వినో	అర్థంతో
ardhamtoo	విదా	అర్థంతో
ardhamlo	పికా	అర్థంలో
arthamlo	తోజు	అర్థంలో
arthamloo	అర్థంలో	అర్థంలో
ardhamavuthundi	జుకాచెదా	అర్ధమవుతుంది
ardhamavutundi	కానోచెదా	అర్ధమవుతుంది
arthamavuthundi	పివిజుతో	అర్ధమవుతుంది
ardhaalanu	పిజు	అర్ధాలను
ardhalanu	అర్ధాలను	అర్ధాలను
alaka	కా	అలక
alarinchaadu	అలరించాడు	అలరించాడు
alarinchadu	తోరుచె	అలరించాడు
alarinchina	అలరించిన	అలరించిన
alavaatayyindhi	రుచెజురు	అలవాటయ్యింది
alavataiyindi	రుదావివి	అలవాటయ్యింది
alavatayyindi	కానోచెవి	అలవాటయ్యింది
alavaataina	అలవాటైన	అలవాటైన
alavataina	అలవాటైన	అలవాటైన
alavatina	అలవాటైన	అలవాటైన
alaantidae	అలాంటిదే	అలాంటిదే
alaantidhe	అలాంటిదే	అలాంటిదే
alantide	చెచె	అలాంటిదే
alpasankhyaaka	అల్పసంఖ్యాక	అల్పసంఖ్యాక
allaadi	నోవి	అల్లాడి
avagaahana	తోవి	అవగాహన
avagahana	తోరు	అవగాహన
avagaahananu	పికా	అవగాహనను
avatharana	అవతరణ	అవతరణ
avatharanha	దా	అవతరణ
avataaramani	కాచె	అవతారమని
avathaaramani	చెనో	అవతారమని
avataaraalu	అవతారాలు	అవతారాలు
avataralu	విదా	అవతారాలు
avathaaraalu	పిచె	అవతారాలు
avathaaralu	జుపి	అవతారాలు
aavaataar	అవతార్	అవతార్
avataar	అవతార్	అవతార్
avatar	అవతార్	అవతార్
avathaar	చెచె	అవతార్
avathar	అవతార్	అవతార్
avetar	తోదా	అవతార్
avannee	లేతో	అవన్నీ
avanni	పిలే	అవన్నీ
avasaramu	విజు	అవసరము
avasaramai	పిపి	అవసరమై
aawaard	రుపి	అవార్డ్
avaard	అవార్డ్	అవార్డ్
award	నోదా	అవార్డ్
avuthundi	నోనో	అవుతుంది
avutundi	అవుతుంది	అవుతుంది
avuthoo	తో	అవుతూ
avuthuu	జు	అవుతూ
avutu	వి	అవుతూ
ashta	పి	అష్టా
ashtaa	లే	అష్టా
asoem	జు	అసోం
asom	అసోం	అసోం
asoom	అసోం	అసోం
awesome	అసోం	అసోం
as	అస్	అస్
ass	జు	అస్
us	నో	అస్
astavyastam	అస్తవ్యస్తం	అస్తవ్యస్తం
asthvyastham	రుతోతో	అస్తవ్యస్తం
astavyastanga	అస్తవ్యస్తంగా	అస్తవ్యస్తంగా
astavyastangaa	చెకావిదా	అస్తవ్యస్తంగా
asthavyasthanga	అస్తవ్యస్తంగా	అస్తవ్యస్తంగా
asthra	అస్త్ర	అస్త్ర
astra	అస్త్ర	అస్త్ర
asthram	తోచె	అస్త్రం
astram	అస్త్రం	అస్త్రం
asthramulu	చెకాచె	అస్త్రములు
astramulu	అస్త్రములు	అస్త్రములు
asthraalanu	అస్త్రాలను	అస్త్రాలను
astraalanu	పిజుదా	అస్త్రాలను
astralanu	చెచెచె	అస్త్రాలను
asthralu	చెపితో	అస్త్రాలు
astraalu	అస్త్రాలు	అస్త్రాలు
astralu	అస్త్రాలు	అస్త్రాలు
aham	రు	అహం
ahalyaku	అహల్యకు	అహల్యకు
ahalya	అహల్యా	అహల్యా
ahalyaa	లేజు	అహల్యా
ahobilam	చెనో	అహోబిలం
ahoobilam	అహోబిలం	అహోబిలం
aantoniyo	రుకా	ఆంటోనియో
antonio	జుదా	ఆంటోనియో
antoniyo	వినో	ఆంటోనియో
aanthoni	లేపి	ఆంథోనీ
aanthoonee	ఆంథోనీ	ఆంథోనీ
anthony	కావి	ఆంథోనీ
antony	ఆంథోనీ	ఆంథోనీ
aamdhra	జు	ఆంధ్ర
aandhra	ఆంధ్ర	ఆంధ్ర
aandhramu	తోజు	ఆంధ్రము
aandramu	కానో	ఆంధ్రము
andhramu	లేచె	ఆంధ్రము
aandhraastram	విదాచెనో	ఆంధ్రరాష్ట్రం
aandhraraashtram	ఆంధ్రరాష్ట్రం	ఆంధ్రరాష్ట్రం
aandraraashtram	ఆంధ్రరాష్ట్రం	ఆంధ్రరాష్ట్రం
aandhralo	పివి	ఆంధ్రలో
aandhraloo	వికా	ఆంధ్రలో
aakaara	నో	ఆకార
aakara	వి	ఆకార
akara	ఆకార	ఆకార
aakaarapu	జుతో	ఆకారపు
aakaaraanni	ఆకారాన్ని	ఆకారాన్ని
aakaaraalu	చెజు	ఆకారాలు
aakaralu	పిచె	ఆకారాలు
aakruthulalo	పిచె	ఆకృతులలో
aakruthulaloo	ఆకృతులలో	ఆకృతులలో
akrutulalo	నోవి	ఆకృతులలో
aakruthulu	ఆకృతులు	ఆకృతులు
akrutulu	ఆకృతులు	ఆకృతులు
actiiviity	ఆక్టివిటీ	ఆక్టివిటీ
activity	తోనోరు	ఆక్టివిటీ
aktiviti	ఆక్టివిటీ	ఆక్టివిటీ
aktivity	జుజులే	ఆక్టివిటీ
aqtiviti	పినోవి	ఆక్టివిటీ
aqtivity	ఆక్టివిటీ	ఆక్టివిటీ
aakramimchaaru	నోలేనో	ఆక్రమించారు
aakraminchaaru	చెపిజు	ఆక్రమించారు
aakramincharu	ఆక్రమించారు	ఆక్రమించారు
aakraminchae	జుజునో	ఆక్రమించే
aakraminche	ఆక్రమించే	ఆక్రమించే
aagakumdaa	ఆగకుండా	ఆగకుండా
aagakunda	నోదా	ఆగకుండా
aagakundaa	ఆగకుండా	ఆగకుండా
agakunda	ఆగకుండా	ఆగకుండా
aagalaedu	ఆగలేదు	ఆగలేదు
aagaledu	ఆగలేదు	ఆగలేదు
aagaleedhu	ఆగలేదు	ఆగలేదు
aachamta	ఆచంట	ఆచంట
aachanta	ఆచంట	ఆచంట
achanta	ఆచంట	ఆచంట
aajaad	చె	ఆజాద్
aajaadh	ఆజాద్	ఆజాద్
aazaad	ఆజాద్	ఆజాద్
aazaadh	రు	ఆజాద్
azad	చె	ఆజాద్
aagnaapinchina	చెతోతో	ఆజ్ఞాపించిన
aajnaapinchina	దాకారు	ఆజ్ఞాపించిన
agnyapinchina	ఆజ్ఞాపించిన	ఆజ్ఞాపించిన
aadina	ఆడిన	ఆడిన
adina	కా	ఆడిన
aathma	ఆత్మ	ఆత్మ
aatma	ఆత్మ	ఆత్మ
athma	ఆత్మ	ఆత్మ
atman	కా	ఆత్మ
etman	నో	ఆత్మ
aathmaku	ఆత్మకు	ఆత్మకు
aatmaku	దాపి	ఆత్మకు
athmaku	ఆత్మకు	ఆత్మకు
aathmaga	లేచె	ఆత్మగా
aatmaga	తోదా	ఆత్మగా
aatmagaa	పిపి	ఆత్మగా
atmaga	లేతో	ఆత్మగా
aathmatho	జుపి	ఆత్మతో
aatmatoo	ఆత్మతో	ఆత్మతో
athmatho	జురు	ఆత్మతో
aatmanu	ఆత్మను	ఆత్మను
athmanu	వినో	ఆత్మను
aathmala	తో	ఆత్మల
aatmala	లే	ఆత్మల
atmala	ఆత్మల	ఆత్మల
aathmalaku	ఆత్మలకు	ఆత్మలకు
aatmalaku	చెకా	ఆత్మలకు
atmalaku	విదా	ఆత్మలకు
aathmalo	పితో	ఆత్మలో
aatmalo	తోతో	ఆత్మలో
aatmaloo	తోనో	ఆత్మలో
atmalo	ఆత్మలో	ఆత్మలో
aadeshinchagaa	కాజుకా	ఆదేశించగా
aadesinchagaa	తోరువి	ఆదేశించగా
aadheshinchagaa	ఆదేశించగా	ఆదేశించగా
aadeshinchadam	ఆదేశించడం	ఆదేశించడం
aadesinchadam	రుకాజు	ఆదేశించడం
adesinchadam	ఆదేశించడం	ఆదేశించడం
aadhmee	చె	ఆద్మీ
aadmee	నో	ఆద్మీ
aadmii	ఆద్మీ	ఆద్మీ
aadhaaramtho	ఆధారంతో	ఆధారంతో
aadhaaranthoo	కాచె	ఆధారంతో
aadharamtoe	తోకా	ఆధారంతో
aadhaaraala	ఆధారాల	ఆధారాల
adharala	ఆధారాల	ఆధారాల
aadhaaraalato	చెనో	ఆధారాలతో
adharalatho	కాలే	ఆధారాలతో
adharalato	రులే	ఆధారాలతో
aadhaaraalanu	ఆధారాలను	ఆధారాలను
adharalanu	పిచె	ఆధారాలను
aadhikyam	ఆధిక్యం	ఆధిక్యం
aadhikyamlo	ఆధిక్యంలో	ఆధిక్యంలో
aadhikyamloe	ఆధిక్యంలో	ఆధిక్యంలో
aadhvaryamulo	ఆధ్వర్యములో	ఆధ్వర్యములో
aadhvaryamuloo	దాతోలే	ఆధ్వర్యములో
aadhwaryamuloo	వికాపి	ఆధ్వర్యములో
aanamdamaya	ఆనందమయ	ఆనందమయ
anandamaya	వితో	ఆనందమయ
operative	రువి	ఆపరేటివ్
aapi	తో	ఆపి
api	ఆపి	ఆపి
aapina	లే	ఆపిన
apina	కా	ఆపిన
aapudu	ఆపుడు	ఆపుడు
aabaga	ఆబగా	ఆబగా
aabagaa	ఆబగా	ఆబగా
abaga	ఆబగా	ఆబగా
aamodhinchaaru	ఆమోదించారు	ఆమోదించారు
aamodinchaaru	చెకాచె	ఆమోదించారు
aamodincharu	చెపితో	ఆమోదించారు
aamodhinchindhi	కారుకా	ఆమోదించింది
aamodinchindi	ఆమోదించింది	ఆమోదించింది
aamodhinchina	ఆమోదించిన	ఆమోదించిన
aamodinchina	జువికా	ఆమోదించిన
aamoodhinche	దాలే	ఆమోదించే
aamoodinchee	తోరు	ఆమోదించే
amodinche	జులే	ఆమోదించే
aamlam	తో	ఆమ్లం
aalmajani	నోరు	ఆమ్లజని
aamlajani	కావి	ఆమ్లజని
aayina	ఆయిన	ఆయిన
ayina	చె	ఆయిన
aayurveda	దాతో	ఆయుర్వేద
ayurveda	తోలే	ఆయుర్వేద
aayurvedam	ఆయుర్వేదం	ఆయుర్వేదం
ayurvedam	ఆయుర్వేదం	ఆయుర్వేదం
aayushshu	జుజు	ఆయుష్షు
aayusshu	ఆయుష్షు	ఆయుష్షు
ayusshu	ఆయుష్షు	ఆయుష్షు
aaraamaalu	రునో	ఆరామాలు
aarimtini	చెతో	ఆరింటిని
aarintini	ఆరింటిని	ఆరింటిని
aarogyakara	దాదా	ఆరోగ్యకర
aaroogyakara	పిచె	ఆరోగ్యకర
aarohana	ఆరోహణ	ఆరోహణ
aarohanha	జు	ఆరోహణ
aaroohana	రు	ఆరోహణ
aarka	తో	ఆర్కా
aarkaa	ఆర్కా	ఆర్కా
arcaa	ఆర్కా	ఆర్కా
aarganaijaeshan	ఆర్గనైజేషన్	ఆర్గనైజేషన్
aarganyjeshan	ఆర్గనైజేషన్	ఆర్గనైజేషన్
organisation	ఆర్గనైజేషన్	ఆర్గనైజేషన్
organisetion	దాలేతో	ఆర్గనైజేషన్
organization	ఆర్గనైజేషన్	ఆర్గనైజేషన్
aargaan	వినో	ఆర్గాన్
argan	దాచె	ఆర్గాన్
orgaan	రుదా	ఆర్గాన్
organ	జునో	ఆర్గాన్
aardharaitis	ఆర్థరైటిస్	ఆర్థరైటిస్
aartharaitis	ఆర్థరైటిస్	ఆర్థరైటిస్
arthritis	ఆర్థరైటిస్	ఆర్థరైటిస్
aardra	ఆర్ద్ర	ఆర్ద్ర
ardra	లేవి	ఆర్ద్ర
aalayamlo	పిపి	ఆలయంలో
aalayamloo	ఆలయంలో	ఆలయంలో
alayamlo	నోచె	ఆలయంలో
aalayaalu	దారు	ఆలయాలు
aalayalu	ఆలయాలు	ఆలయాలు
aalayyalu	నోచె	ఆలయాలు
alayalu	తోరు	ఆలయాలు
aalasyam	దాజు	ఆలస్యం
alasyam	ఆలస్యం	ఆలస్యం
aalasyamgaa	తోచె	ఆలస్యంగా
alasyamga	కారు	ఆలస్యంగా
aalasyamu	దానో	ఆలస్యము
alasyamu	ఆలస్యము	ఆలస్యము
aalochanatho	జుతో	ఆలోచనతో
aalochanato	ఆలోచనతో	ఆలోచనతో
alochanatho	ఆలోచనతో	ఆలోచనతో
alochanato	కాచె	ఆలోచనతో
aalochanalanu	లేతో	ఆలోచనలను
alochanalanu	ఆలోచనలను	ఆలోచనలను
aavagimjamta	ఆవగింజంత	ఆవగింజంత
aavaginjamta	దానో	ఆవగింజంత
aavaginjantha	తోకా	ఆవగింజంత
aavidhamgaa	కాచె	ఆవిధంగా
aavidhangaa	ఆవిధంగా	ఆవిధంగా
aasaya	ఆశయ	ఆశయ
aashaya	పి	ఆశయ
aashayaanni	రులే	ఆశయాన్ని
aashayanni	ఆశయాన్ని	ఆశయాన్ని
aasramamlo	ఆశ్రమంలో	ఆశ్రమంలో
asramamlo	నోచె	ఆశ్రమంలో
aashramaallo	లేనోజు	ఆశ్రమాల్లో
aasramaalla	దాలేనో	ఆశ్రమాల్లో
aasramaallo	ఆశ్రమాల్లో	ఆశ్రమాల్లో
aashrayincharu	దాతోరు	ఆశ్రయించారు
aasrayinchaaru	తోనోకా	ఆశ్రయించారు
asrayincharu	పిదారు	ఆశ్రయించారు
aastreliyaa	విజునో	ఆస్ట్రేలియా
aaustrelia	జుకానో	ఆస్ట్రేలియా
australia	ఆస్ట్రేలియా	ఆస్ట్రేలియా
australiaa	ఆస్ట్రేలియా	ఆస్ట్రేలియా
austrelia	ఆస్ట్రేలియా	ఆస్ట్రేలియా
aastreeliyaapai	రుజుతోపి	ఆస్ట్రేలియాపై
aastreliyaapai	చెతోవినో	ఆస్ట్రేలియాపై
australiapai	ఆస్ట్రేలియాపై	ఆస్ట్రేలియాపై
austreliapai	విరుజుతో	ఆస్ట్రేలియాపై
aastreeliyaaloo	ఆస్ట్రేలియాలో	ఆస్ట్రేలియాలో
aastreliyaaloo	ఆస్ట్రేలియాలో	ఆస్ట్రేలియాలో
australialo	ఆస్ట్రేలియాలో	ఆస్ట్రేలియాలో
austrelialoo	కాచెలేజు	ఆస్ట్రేలియాలో
aastraeliyaaloeni	ఆస్ట్రేలియాలోని	ఆస్ట్రేలియాలోని
aastreeliyaalooni	లేనోకారుజు	ఆస్ట్రేలియాలోని
aastreliyaalooni	ఆస్ట్రేలియాలోని	ఆస్ట్రేలియాలోని
australialoni	జుచెతోచెజు	ఆస్ట్రేలియాలోని
austrelialoni	తోవిపికాచె	ఆస్ట్రేలియాలోని
aastamaa	జుపి	ఆస్తమా
aasthamaa	ఆస్తమా	ఆస్తమా
asthma	ఆస్తమా	ఆస్తమా
aaharamtho	తోతో	ఆహారంతో
aaharamthoo	ఆహారంతో	ఆహారంతో
ahaaramtoo	ఆహారంతో	ఆహారంతో
aahaaramlooni	ఆహారంలోని	ఆహారంలోని
aaharamloni	ఆహారంలోని	ఆహారంలోని
aaharamlooni	కాచెలే	ఆహారంలోని
aahaaramugaa	కారు	ఆహారముగా
aaharamuga	ఆహారముగా	ఆహారముగా
aaharamugaa	దారు	ఆహారముగా
aahaaramuloo	ఆహారములో	ఆహారములో
aaharamuloo	విచె	ఆహారములో
aharamulo	ఆహారములో	ఆహారములో
inkonni	తోవి	ఇంకొన్ని
inc	దా	ఇంక్
ink	ఇంక్	ఇంక్
inq	రు	ఇంక్
inti	ఇంటి	ఇంటి
intiperlu	జురురు	ఇంటిపేర్లు
intilo	విలే	ఇంటిలో
intiloo	జుతో	ఇంటిలో
intlo	కాలే	ఇంట్లొ
indoor	ఇండోర్	ఇండోర్
indor	ఇండోర్	ఇండోర్
indore	కాచె	ఇండోర్
indur	దాదా	ఇండోర్
inta	చె	ఇంత
intha	జు	ఇంత
imtaku	ఇంతకు	ఇంతకు
intaku	రు	ఇంతకు
inthaku	పి	ఇంతకు
imtagaa	పి	ఇంతగా
intaga	ఇంతగా	ఇంతగా
inthagaa	పి	ఇంతగా
imtaloe	ఇంతలో	ఇంతలో
intalo	లే	ఇంతలో
imtaa	ఇంతా	ఇంతా
intaa	ఇంతా	ఇంతా
imtoe	పి	ఇంతో
intho	నో	ఇంతో
into	రు	ఇంతో
imdali	ఇందలి	ఇందలి
indali	నో	ఇందలి
imdrunitoe	రునోజు	ఇంద్రునితో
indrunito	పిజురు	ఇంద్రునితో
impugaa	తోదా	ఇంపుగా
inpugaa	పిజు	ఇంపుగా
icchaapuram	ఇచ్ఛాపురం	ఇచ్ఛాపురం
icchapuram	ఇచ్ఛాపురం	ఇచ్ఛాపురం
ichchaapuram	ఇచ్ఛాపురం	ఇచ్ఛాపురం
etara	ఇతర	ఇతర
itara	ఇతర	ఇతర
ithara	ఇతర	ఇతర
itaramulu	ఇతరములు	ఇతరములు
itharamulu	ఇతరములు	ఇతరములు
itaraalu	ఇతరాలు	ఇతరాలు
itharaalu	పినో	ఇతరాలు
itharalu	జులే	ఇతరాలు
etivruttam	ఇతివృత్తం	ఇతివృత్తం
ithivrutham	చెకాలే	ఇతివృత్తం
ithivruttham	విజుతో	ఇతివృత్తం
etivrutramgaa	దాపితో	ఇతివృత్తంగా
ithivruthamga	రుజుచె	ఇతివృత్తంగా
etivruttaanni	వివిచెరు	ఇతివృత్తాన్ని
ithivrutthaanni	ఇతివృత్తాన్ని	ఇతివృత్తాన్ని
itivruttaanni	ఇతివృత్తాన్ని	ఇతివృత్తాన్ని
ithivrutthaalu	చెరుకా	ఇతివృత్తాలు
itivruttaalu	దాకావి	ఇతివృత్తాలు
ittadi	ఇత్తడి	ఇత్తడి
itthadi	వినో	ఇత్తడి
iddari	దాజు	ఇద్దరి
iddhari	ఇద్దరి	ఇద్దరి
iddariki	విదా	ఇద్దరికి
iddhariki	చెరు	ఇద్దరికి
iddarini	రుచె	ఇద్దరిని
iddharini	రురు	ఇద్దరిని
iddarilonu	ఇద్దరిలోనూ	ఇద్దరిలోనూ
iddariloonoo	ఇద్దరిలోనూ	ఇద్దరిలోనూ
iddariloonuu	ఇద్దరిలోనూ	ఇద్దరిలోనూ
iddarni	ఇద్దర్ని	ఇద్దర్ని
innayya	విరు	ఇన్నయ్య
iner	ఇన్నర్	ఇన్నర్
innar	ఇన్నర్	ఇన్నర్
inner	కాజు	ఇన్నర్
ippati	ఇప్పటి	ఇప్పటి
ippatike	రునో	ఇప్పటికే
evv	ఇవివి	ఇవివి
ivivi	జు	ఇవివి
ivee	పి	ఇవీ
ivi	దా	ఇవీ
ivvadhu	రులే	ఇవ్వడు
ivvadu	రుచె	ఇవ్వడు
ivvadhu	ఇవ్వదు	ఇవ్వదు
ivvadu	తోకా	ఇవ్వదు
eekviti	ఈక్విటీ	ఈక్విటీ
eekvitii	కాచె	ఈక్విటీ
ekuity	కాచె	ఈక్విటీ
equiti	ఈక్విటీ	ఈక్విటీ
equity	విరు	ఈక్విటీ
iquity	పిలే	ఈక్విటీ
eetadu	ఈతడు	ఈతడు
eethadu	ఈతడు	ఈతడు
ethadu	చె	ఈతడు
eenela	ఈనెల	ఈనెల
inela	వి	ఈనెల
eerendu	ఈరెండు	ఈరెండు
erendu	దాకా	ఈరెండు
eelogaa	ఈలోగా	ఈలోగా
eeloogaa	రు	ఈలోగా
eevv	నో	ఈవ్
eve	వి	ఈవ్
ivi	వి	ఈవ్
unchaali	దాతో	ఉంచాలి
undadi	ఉండండి	ఉండండి
undandi	ఉండండి	ఉండండి
vumdamdi	వికా	ఉండండి
undagaladhu	ఉండగలదు	ఉండగలదు
undagaladu	ఉండగలదు	ఉండగలదు
undavacchunani	ఉండవచ్చునని	ఉండవచ్చునని
undavachhunani	ఉండవచ్చునని	ఉండవచ్చునని
vumdavacchunani	ఉండవచ్చునని	ఉండవచ్చునని
umduta	జు	ఉండుట
unduta	ఉండుట	ఉండుట
umdutachae	తోచె	ఉండుటచే
undutachae	విదా	ఉండుటచే
undutache	ఉండుటచే	ఉండుటచే
umdenu	దాదా	ఉండెను
undenu	తోవి	ఉండెను
undannadi	ఉందన్నది	ఉందన్నది
undhannadi	ఉందన్నది	ఉందన్నది
undho	కా	ఉందో
undhoo	ఉందో	ఉందో
undo	లే	ఉందో
uchita	చె	ఉచిత
uchitam	ఉచితం	ఉచితం
uchitamgaa	జుజు	ఉచితంగా
uchitamaina	లేతో	ఉచితమైన
uchitamiena	ఉచితమైన	ఉచితమైన
ucchaarana	నోలే	ఉచ్ఛారణ
uchchaaranha	దాతో	ఉచ్ఛారణ
uchhaarana	పివి	ఉచ్ఛారణ
udikinchaali	నోవిలే	ఉడికించాలి
udikinchali	వివిలే	ఉడికించాలి
udikinchi	కాతో	ఉడికించి
udikinchina	పిరుదా	ఉడికించిన
uttama	ఉత్తమ	ఉత్తమ
utthama	ఉత్తమ	ఉత్తమ
uttamam	ఉత్తమం	ఉత్తమం
utthamam	చెపి	ఉత్తమం
uttamamga	నోవి	ఉత్తమంగా
uttamamgaa	జుతో	ఉత్తమంగా
uttamangaa	నోతో	ఉత్తమంగా
utthamamgaa	కాకా	ఉత్తమంగా
uttamamaina	జులే	ఉత్తమమైన
utthamamaina	ఉత్తమమైన	ఉత్తమమైన
uthamulu	ఉత్తములు	ఉత్తములు
uttamulu	రువి	ఉత్తములు
uttaraayanamu	పిజులే	ఉత్తరాయణము
uttarayanamu	ఉత్తరాయణము	ఉత్తరాయణము
uttharayanam	ఉత్తరాయణము	ఉత్తరాయణము
udayam	తో	ఉదయం
vudayam	ఉదయం	ఉదయం
udayapu	దా	ఉదయపు
vudayapu	ఉదయపు	ఉదయపు
udayaaniki	ఉదయానికి	ఉదయానికి
udayaniki	ఉదయానికి	ఉదయానికి
udayimchae	కాతో	ఉదయించే
udayinche	విలే	ఉదయించే
udaara	దా	ఉదార
udara	పి	ఉదార
unna	ఉన్న	ఉన్న
unnamta	విజు	ఉన్నంత
unnanta	చెనో	ఉన్నంత
unnantha	ఉన్నంత	ఉన్నంత
unnantavaraku	ఉన్నంతవరకూ	ఉన్నంతవరకూ
unnantavarakuu	తోదారు	ఉన్నంతవరకూ
unnanthavaraku	కాదారు	ఉన్నంతవరకూ
unnadi	కాదా	ఉన్నది
unnaadani	ఉన్నాడని	ఉన్నాడని
unnadani	విదా	ఉన్నాడని
unnaaramtae	చెకారు	ఉన్నారంటే
unnaarantae	చెవికా	ఉన్నారంటే
unnaranta	తోరువి	ఉన్నారంటే
upakhandam	తోరు	ఉపఖండం
uparitala	నోనో	ఉపరితల
uparithal	ఉపరితల	ఉపరితల
uparitalaaniki	ఉపరితలానికి	ఉపరితలానికి
uparithalaaniki	కాదాపి	ఉపరితలానికి
urdoolo	ఉర్దూలో	ఉర్దూలో
urdulo	ఉర్దూలో	ఉర్దూలో
urduloo	ఉర్దూలో	ఉర్దూలో
usirikaaya	వివి	ఉసిరికాయ
usirikaya	ఉసిరికాయ	ఉసిరికాయ
ooregi	ఊరేగి	ఊరేగి
uureegi	కా	ఊరేగి
vuregi	వి	ఊరేగి
oollo	ఊళ్లో	ఊళ్లో
oolloo	కా	ఊళ్లో
oolloni	తోలే	ఊళ్లోని
oollooni	ఊళ్లోని	ఊళ్లోని
oohaathmaka	పితో	ఊహాత్మక
oohaatmaka	ఊహాత్మక	ఊహాత్మక
uhaatmaka	తోలే	ఊహాత్మక
uuhaatmaka	ఊహాత్మక	ఊహాత్మక
vuhaatmaka	చెపి	ఊహాత్మక
oohisthaaru	జురులే	ఊహిస్తారు
uuhistaaru	ఊహిస్తారు	ఊహిస్తారు
vuhistaaru	తోజుదా	ఊహిస్తారు
rushini	ఋషిని	ఋషిని
emem	ఎంఎం	ఎంఎం
mm	ఎంఎం	ఎంఎం
enchukuna	ఎంచుకున్న	ఎంచుకున్న
enchukunna	కావిచె	ఎంచుకున్న
enchukunnaadu	ఎంచుకున్నాడు	ఎంచుకున్నాడు
enchukunnadu	ఎంచుకున్నాడు	ఎంచుకున్నాడు
enchukunnnaadu	ఎంచుకున్నాడు	ఎంచుకున్నాడు
enchukunnaaru	ఎంచుకున్నారు	ఎంచుకున్నారు
enchukunnaru	ఎంచుకున్నారు	ఎంచుకున్నారు
enda	ఎండ	ఎండ
yenda	ఎండ	ఎండ
endaku	జు	ఎండకు
yendaku	ఎండకు	ఎండకు
endinchi	చెరు	ఎండించి
yendinchi	ఎండించి	ఎండించి
entavarakuu	కాదా	ఎంతవరకూ
enthavarakuu	ఎంతవరకూ	ఎంతవరకూ
yentavaraku	ఎంతవరకూ	ఎంతవరకూ
mv	జు	ఎంవీ
egaradaaniki	పికానో	ఎగరడానికి
egaradaniki	జుకానో	ఎగరడానికి
edagadaaniki	రుచెతో	ఎదగడానికి
edhagadaaniki	ఎదగడానికి	ఎదగడానికి
edhigaadu	ఎదిగాడు	ఎదిగాడు
edigaadu	ఎదిగాడు	ఎదిగాడు
edhigaaru	విజు	ఎదిగారు
edigaaru	పితో	ఎదిగారు
edhigindhi	ఎదిగింది	ఎదిగింది
edigindi	ఎదిగింది	ఎదిగింది
eddhunu	ఎద్దును	ఎద్దును
eddunu	ఎద్దును	ఎద్దును
ennadu	విరు	ఎన్నడు
ennadoo	కాదా	ఎన్నడూ
ennadu	లేలే	ఎన్నడూ
ennaduu	ఎన్నడూ	ఎన్నడూ
alugu	లే	ఎలుగు
elugu	కా	ఎలుగు
yelugu	రు	ఎలుగు
evadaite	ఎవడైతే	ఎవడైతే
evadiete	కాలే	ఎవడైతే
yevadaithe	ఎవడైతే	ఎవడైతే
ekeekarana	తోదా	ఏకీకరణ
yekekarana	లేతో	ఏకీకరణ
yekikarana	ఏకీకరణ	ఏకీకరణ
agency	ఏజన్సీ	ఏజన్సీ
ejansi	నోతో	ఏజన్సీ
aenaatikee	చెవి	ఏనాటికీ
enatiki	దారు	ఏనాటికీ
yenatikii	జునో	ఏనాటికీ
aenaaduu	చె	ఏనాడూ
enadu	లే	ఏనాడూ
yenadu	దా	ఏనాడూ
aenugunu	దారు	ఏనుగును
enugunu	రులే	ఏనుగును
yenugunu	ఏనుగును	ఏనుగును
aenugulu	జులే	ఏనుగులు
enugulu	ఏనుగులు	ఏనుగులు
yenugulu	నోతో	ఏనుగులు
epani	లే	ఏపని
yepani	లే	ఏపని
amantee	కా	ఏమంటే
emante	చె	ఏమంటే
yemante	జు	ఏమంటే
amanagaa	లే	ఏమనగా
emanagaa	చె	ఏమనగా
yemanaga	తో	ఏమనగా
aemaathram	ఏమాత్రం	ఏమాత్రం
ematram	ఏమాత్రం	ఏమాత్రం
yemathram	నోనో	ఏమాత్రం
arealalo	ఏరియాలలో	ఏరియాలలో
arealaloo	ఏరియాలలో	ఏరియాలలో
eriyalalo	దాదా	ఏరియాలలో
aares	ఏరియాస్	ఏరియాస్
areas	ఏరియాస్	ఏరియాస్
ares	జునో	ఏరియాస్
areys	కాతో	ఏరియాస్
aerpadaka	ఏర్పడక	ఏర్పడక
erpadaka	ఏర్పడక	ఏర్పడక
yerpadaka	పిపి	ఏర్పడక
aerpadataaniki	రునోదా	ఏర్పడటానికి
erpadataaniki	ఏర్పడటానికి	ఏర్పడటానికి
erpadataniki	దాలేనో	ఏర్పడటానికి
yerpadataaniki	ఏర్పడటానికి	ఏర్పడటానికి
aerpadadam	దాపి	ఏర్పడడం
erpadadam	కాకా	ఏర్పడడం
yerpadadam	జుదా	ఏర్పడడం
aerpadadaaniki	విజునో	ఏర్పడడానికి
erpadadaaniki	ఏర్పడడానికి	ఏర్పడడానికి
erpadadaniki	ఏర్పడడానికి	ఏర్పడడానికి
yerpadadaaniki	విరుచె	ఏర్పడడానికి
erpadindani	తోనోకా	ఏర్పడిందని
yerpadindani	నోతోతో	ఏర్పడిందని
erpadindi	దాచెపి	ఏర్పడింది
yerpadindi	ఏర్పడింది	ఏర్పడింది
erpadenduku	ఏర్పడేందుకు	ఏర్పడేందుకు
yerpadenduku	ఏర్పడేందుకు	ఏర్పడేందుకు
eerparichaaru	లేలేజు	ఏర్పరిచారు
erparicharu	ఏర్పరిచారు	ఏర్పరిచారు
yerparicharu	ఏర్పరిచారు	ఏర్పరిచారు
elina	కా	ఏలిన
yelina	నో	ఏలిన
ella	ఏళ్ల	ఏళ్ల
yella	ఏళ్ల	ఏళ్ల
ellaku	లేలే	ఏళ్లకు
yellaku	ఏళ్లకు	ఏళ్లకు
ellalo	ఏళ్లలో	ఏళ్లలో
yellalo	పికా	ఏళ్లలో
ellu	ఏళ్లు	ఏళ్లు
yellu	ఏళ్లు	ఏళ్లు
elluga	తోచె	ఏళ్లుగా
ellugaa	తోతో	ఏళ్లుగా
yelluga	చెదా	ఏళ్లుగా
aichhika	కారు	ఐచ్ఛిక
icchika	లేనో	ఐచ్ఛిక
ichchika	దాలే	ఐచ్ఛిక
ainappataki	జుతోవి	ఐనప్పటికీ
ainappatiki	ఐనప్పటికీ	ఐనప్పటికీ
inappatikee	కాదాచె	ఐనప్పటికీ
ontari	ఒంటరి	ఒంటరి
okadigaa	ఒకడిగా	ఒకడిగా
okaanoka	కాలే	ఒకానొక
okanoka	లేచె	ఒకానొక
odalu	ఒడలు	ఒడలు
opo	లే	ఒప్పో
oppo	వి	ఒప్పో
oravadi	ఒరవడి	ఒరవడి
oravadini	రుతో	ఒరవడిని
oraacle	ఒరాకిల్	ఒరాకిల్
oraakil	నోచె	ఒరాకిల్
oracle	తోరు	ఒరాకిల్
orakle	ఒరాకిల్	ఒరాకిల్
ollhu	పి	ఒళ్లు
ollu	ఒళ్లు	ఒళ్లు
omkaaramu	రుచె	ఓంకారము
oomkaaramu	నోలే	ఓంకారము
otarla	చె	ఓటర్ల
voterla	చె	ఓటర్ల
odela	వి	ఓదెల
oodela	జు	ఓదెల
oopikaagaa	తోలే	ఓపికగా
opikaga	ఓపికగా	ఓపికగా
opikagaa	లేపి	ఓపికగా
ohrugallunu	రుదావి	ఓరుగల్లును
oorugallunu	ఓరుగల్లును	ఓరుగల్లును
orugallunu	ఓరుగల్లును	ఓరుగల్లును
au	ఔ	ఔ
ou	ఔ	ఔ
ow	చె	ఔ
aunu	ఔను	ఔను
ounu	ఔను	ఔను
conductor	కండక్టర్	కండక్టర్
conduuctor	తోరు	కండక్టర్
kamdaktar	కండక్టర్	కండక్టర్
kanductor	జుతో	కండక్టర్
konduktor	కండక్టర్	కండక్టర్
conductorlu	పినోచె	కండక్టర్లు
kamdaktarlu	రుకాపి	కండక్టర్లు
kandara	దా	కండర
kandaram	దా	కండరం
kamdaraala	కండరాల	కండరాల
kandaraala	కండరాల	కండరాల
kamdaraalaku	కండరాలకు	కండరాలకు
kandaraalaku	చెకా	కండరాలకు
kampu	జు	కంపు
compose	కంపోజ్	కంపోజ్
kampose	పిచె	కంపోజ్
kompose	విచె	కంపోజ్
kachchaerii	తోతో	కచ్చేరీ
kacheerii	పినో	కచ్చేరీ
kachheri	కచ్చేరీ	కచ్చేరీ
cousin	నో	కజిన్
couzin	చె	కజిన్
kajin	కజిన్	కజిన్
kattalu	తోవి	కట్టలు
kattaa	జు	కట్టా
kattaaru	లేతో	కట్టారు
kattaru	కట్టారు	కట్టారు
kattaalani	కట్టాలని	కట్టాలని
kattimchadam	పిదాకా	కట్టించడం
kattinchadam	కట్టించడం	కట్టించడం
kattimchaaru	లేనోలే	కట్టించారు
kattinchaaru	చెతోకా	కట్టించారు
kattimchi	కావి	కట్టించి
kattinchi	రువి	కట్టించి
kattimdi	జుచె	కట్టింది
kattindi	కట్టింది	కట్టింది
katnam	దా	కట్నం
kathina	వి	కఠిన
kadimi	కడిమి	కడిమి
kadupu	జు	కడుపు
kadupuna	రురు	కడుపున
kadupuni	జుచె	కడుపుని
kadupuloeki	కడుపులోకి	కడుపులోకి
kadupulooki	నోలేవి	కడుపులోకి
kadupuloeni	కడుపులోని	కడుపులోని
kadupulooni	పితోరు	కడుపులోని
kanaalugaa	నోతో	కణాలుగా
kanithi	కణితి	కణితి
kaniti	కణితి	కణితి
kadhakudu	కథకుడు	కథకుడు
kathakudu	కావి	కథకుడు
kadhanaalaku	పినో	కథనాలకు
kathanaalaku	కథనాలకు	కథనాలకు
kadhanaalu	రురు	కథనాలు
kathanaalu	వికా	కథనాలు
kadapadam	కదపడం	కదపడం
kadhapadam	కదపడం	కదపడం
kadalakundaa	రుజు	కదలకుండా
kadaladam	వి	కదలడం
kadalani	కదలని	కదలని
kadhilinchi	రునో	కదిలించి
kadilimchi	చెజు	కదిలించి
kadilindi	కదిలించి	కదిలించి
kadhalanu	వి	కధలను
kathalanu	తో	కధలను
kadhalugaa	తోజు	కధలుగా
kathalugaa	జుపి	కధలుగా
kani	తో	కని
kanipistaayi	కనిపిస్తాయి	కనిపిస్తాయి
kanipisthaayi	కనిపిస్తాయి	కనిపిస్తాయి
kannadam	కన్నడం	కన్నడం
kannu	జు	కన్ను
kannunu	కన్నును	కన్నును
kannulu	కన్నులు	కన్నులు
kanya	రు	కన్యా
kanyaa	చె	కన్యా
convention	రుపిపి	కన్వెన్షన్
kanvenshan	రురులే	కన్వెన్షన్
konvention	కన్వెన్షన్	కన్వెన్షన్
kapili	కపిలి	కపిలి
kamaneeyamga	కావి	కమనీయంగా
kamaneeyamgaa	కమనీయంగా	కమనీయంగా
kamaneeyangaa	నోపి	కమనీయంగా
kamalaa	వి	కమలా
kaaraachi	దా	కరాచీ
karaachee	జు	కరాచీ
karachi	కరాచీ	కరాచీ
karakhi	రు	కరాచీ
qarachi	కరాచీ	కరాచీ
karigina	తోజు	కరిగిన
karivaepaaku	రురుతో	కరివేపాకు
kariveepaaku	కరివేపాకు	కరివేపాకు
karivepaaku	కరివేపాకు	కరివేపాకు
karuvunu	జుజు	కరువును
karshaka	కర్షక	కర్షక
kalagalasina	జుదా	కలగలసిన
kaladee	లే	కలదీ
kaladi	కలదీ	కలదీ
kaladii	కలదీ	కలదీ
kalabanda	కా	కలబంద
kalabandha	కలబంద	కలబంద
kalabandanu	కలబందను	కలబందను
kalabandhanu	కానో	కలబందను
cholera	కలరా	కలరా
kalara	పి	కలరా
kalaraa	లే	కలరా
kalraa	కలరా	కలరా
kalalannee	కలలన్నీ	కలలన్నీ
kalalanni	కలలన్నీ	కలలన్నీ
kalavaadu	కలవాడు	కలవాడు
kalavadu	కలవాడు	కలవాడు
kaligaadu	విచె	కలిగాడు
kaligina	నోచె	కలిగిన
kaliginavaaru	కలిగినవారు	కలిగినవారు
kaliginavaru	లేవిచె	కలిగినవారు
kaligina	చెజు	కలిగినా
kaliginaa	కలిగినా	కలిగినా
kaligenu	కలిగెను	కలిగెను
kalimi	లే	కలిమి
kaliyuga	కలియుగ	కలియుగ
kalugadhu	కలుగదు	కలుగదు
kalugadu	జుకా	కలుగదు
kalugu	కలుగు	కలుగు
kalugunu	విచె	కలుగును
kalusukuni	దాలేలే	కలుసుకుని
collectaru	కలెక్టరు	కలెక్టరు
collectoru	పిలే	కలెక్టరు
kalektaru	లేవి	కలెక్టరు
kalpinchinaa	కల్పించినా	కల్పించినా
kalyaanam	దాదా	కల్యాణం
kalyaani	జుతో	కల్యాణి
kavayitri	పిజు	కవయిత్రి
kayithri	కవయిత్రి	కవయిత్రి
kavayithriga	లేనోదా	కవయిత్రిగా
kavayitriga	కవయిత్రిగా	కవయిత్రిగా
kavayitrigaa	చెపిరు	కవయిత్రిగా
covar	వి	కవర్
cover	కవర్	కవర్
kover	కవర్	కవర్
kavarla	నో	కవర్ల
kavitala	కవితల	కవితల
kavithala	కవితల	కవితల
kavitalanu	కాజు	కవితలను
kavithalanu	పిపి	కవితలను
kavitalalo	కవితలలో	కవితలలో
kavitalaloe	కవితలలో	కవితలలో
kavithalaloo	కవితలలో	కవితలలో
kavitalu	కవితలు	కవితలు
kavithalu	జుతో	కవితలు
kashta	దా	కష్ట
kashtapadadam	కాచె	కష్టపడడం
kashtamu	లేదా	కష్టము
kashtamai	కష్టమై	కష్టమై
kashtamie	లేదా	కష్టమై
kashtamy	లేతో	కష్టమై
kashtamaina	కష్టమైన	కష్టమైన
kashtamiena	కష్టమైన	కష్టమైన
kashtaalloe	లేచెకా	కష్టాల్లో
kashtallo	తోరుపి	కష్టాల్లో
customers	కాదా	కస్టమ్స్
customs	కస్టమ్స్	కస్టమ్స్
cuustoms	దాజు	కస్టమ్స్
kastams	కస్టమ్స్	కస్టమ్స్
kaakatiyula	కాకతీయుల	కాకతీయుల
kakateeyula	కాకతీయుల	కాకతీయుల
kakatiyula	కాకతీయుల	కాకతీయుల
kaatamaraaju	పిచె	కాటమరాజు
kaatu	నో	కాటు
kaatuka	కాటుక	కాటుక
kaatuku	పిజు	కాటుకు
kaanivi	లేచె	కానివి
kanivi	దాకా	కానివి
kaabul	దాలే	కాబూల్
kabool	తోనో	కాబూల్
kabul	దాచె	కాబూల్
comic	లేలే	కామిక్
kamik	కామిక్	కామిక్
komik	తోతో	కామిక్
comradelu	పిపిజు	కామ్రేడ్లు
kaamredlu	దాదావి	కామ్రేడ్లు
kamredlu	లేదాదా	కామ్రేడ్లు
kaayadam	కాయడం	కాయడం
kayadam	దా	కాయడం
kaayadaaniki	జుజుపి	కాయడానికి
kayadaniki	కానోచె	కాయడానికి
kaayanu	కాయను	కాయను
kayanu	పి	కాయను
kaayamu	కా	కాయము
kayamu	లే	కాయము
kaaradam	కారడం	కారడం
kaanam	కారణం	కారణం
kaaranam	కారణం	కారణం
caart	కార్ట్	కార్ట్
cart	తోచె	కార్ట్
kaart	విలే	కార్ట్
kart	తోవి	కార్ట్
qart	తోచె	కార్ట్
caarbon	కాదా	కార్బన్
carbon	కాజు	కార్బన్
corban	తోపి	కార్బన్
corbon	విలే	కార్బన్
karbon	నోదా	కార్బన్
kaarya	కార్య	కార్య
karya	చె	కార్య
kaaryaalayamloone	కార్యాలయంలోనే	కార్యాలయంలోనే
karyalayamlone	తోకాచెకా	కార్యాలయంలోనే
karyalayamloonae	కార్యాలయంలోనే	కార్యాలయంలోనే
kaalakramena	కాలక్రమేణ	కాలక్రమేణ
kalakramena	రుకాలే	కాలక్రమేణ
kaalavyavadhi	పినోదా	కాలవ్యవధి
kaalavyavadhilo	వివిజు	కాలవ్యవధిలో
caalendar	కాలెండర్	కాలెండర్
calendar	కాలెండర్	కాలెండర్
kaalendar	తోపి	కాలెండర్
kaalender	చెనో	కాలెండర్
caall	కాల్	కాల్
cal	కాల్	కాల్
call	కాల్	కాల్
kaal	జు	కాల్
kall	కాల్	కాల్
kaalpanika	నోపి	కాల్పనిక
caalls	నోవి	కాల్స్
calls	కాల్స్	కాల్స్
cals	నోలే	కాల్స్
kaals	రుచె	కాల్స్
kaalidaasu	కాళిదాసు	కాళిదాసు
kaalidasu	నోపి	కాళిదాసు
kaalidhaasu	కాళిదాసు	కాళిదాసు
kaali	కాళీ	కాళీ
kali	జు	కాళీ
qali	కాళీ	కాళీ
kaavacchu	పిపి	కావచ్చు
kaavachhu	చెజు	కావచ్చు
kaavatamtho	చెతో	కావటంతో
kaavatamto	నోపి	కావటంతో
kaavatamtoo	కావటంతో	కావటంతో
kaavadaaniki	కావడానికి	కావడానికి
kaavadaniki	కావడానికి	కావడానికి
kaavalisina	పినో	కావలిసిన
kaavalsina	చెకా	కావలిసిన
kaasiki	లేచె	కాశీకి
kashiki	రుచె	కాశీకి
kaasilo	విరు	కాశీలో
kaasiloe	విచె	కాశీలో
kaasiloo	కావి	కాశీలో
kaase	కాసే	కాసే
kase	లే	కాసే
costume	చెదాజు	కాస్ట్యూమ్
costuume	కాచెకా	కాస్ట్యూమ్
kichan	లే	కిచన్
kitchen	పి	కిచన్
kimidi	కిమిడి	కిమిడి
kiranaala	కానో	కిరణాల
kiranala	కిరణాల	కిరణాల
kiranhaala	కిరణాల	కిరణాల
kishtamaina	తోకా	కిష్టమైన
kishtmaina	చెనో	కిష్టమైన
kisaan	నోపి	కిసాన్
kissan	కిసాన్	కిసాన్
kish	కిస్	కిస్
kiss	కిస్	కిస్
qiss	తో	కిస్
keiith	జు	కీత్
keith	కీత్	కీత్
qeith	కీత్	కీత్
keeboordu	కీబోర్డు	కీబోర్డు
keyboardu	కీబోర్డు	కీబోర్డు
keerti	లేపి	కీర్తి
kirthi	కావి	కీర్తి
kirti	కీర్తి	కీర్తి
keerthini	పిదా	కీర్తిని
keertini	కీర్తిని	కీర్తిని
kirthini	కీర్తిని	కీర్తిని
kunti	రు	కుంటి
kunthee	జు	కుంతీ
kunthii	కుంతీ	కుంతీ
kunti	కుంతీ	కుంతీ
cookie	కుకీ	కుకీ
cukie	నో	కుకీ
cukiie	నో	కుకీ
cuqie	కుకీ	కుకీ
kukee	దా	కుకీ
kuki	కుకీ	కుకీ
kukie	కుకీ	కుకీ
kutra	కుట్ర	కుట్ర
kutraku	కాలే	కుట్రకు
kutralo	తోజు	కుట్రలో
kutraloo	కుట్రలో	కుట్రలో
kuneevaaru	కునేవారు	కునేవారు
kunevaaru	కునేవారు	కునేవారు
kootiki	జుదా	కూటికి
kuutiki	దారు	కూటికి
koothurlu	చెజు	కూతుర్లు
kuuthurlu	రునో	కూతుర్లు
kooragayalatho	చెనోనో	కూరగాయలతో
kuuragaayalatho	కాతోదా	కూరగాయలతో
kuuragayalathoo	కూరగాయలతో	కూరగాయలతో
kooragayalanu	కూరగాయలను	కూరగాయలను
kuuragaayalanu	దాపితో	కూరగాయలను
kuuragayalanu	కూరగాయలను	కూరగాయలను
kooragayalu	నోచె	కూరగాయలు
kuuragaayalu	తోరు	కూరగాయలు
kuuragayalu	కాజు	కూరగాయలు
koolindhi	కూలింది	కూలింది
kuulindhi	పివి	కూలింది
kuulindi	కూలింది	కూలింది
kru	దా	కృ
krishnaarjunulu	కాజులేరు	కృష్ణార్జునులు
krishnarjunulu	కృష్ణార్జునులు	కృష్ణార్జునులు
krushnaarjunulu	పిలేవిజు	కృష్ణార్జునులు
krushnarjunulu	కృష్ణార్జునులు	కృష్ణార్జునులు
kechap	కెచప్	కెచప్
ketchap	కెచప్	కెచప్
ketchup	కెచప్	కెచప్
ketkhup	పి	కెచప్
qetchup	పి	కెచప్
kenyaalo	కెన్యాలో	కెన్యాలో
kenyalo	దారు	కెన్యాలో
camerala	లేదా	కెమెరాల
kemerala	కెమెరాల	కెమెరాల
k	చె	కే
kai	కే	కే
kay	కే	కే
ke	కే	కే
qay	కే	కే
kendra	పిలే	కేంద్ర
kendraaniki	కేంద్రానికి	కేంద్రానికి
kendraniki	కేంద్రానికి	కేంద్రానికి
kongu	కొంగు	కొంగు
kottuku	కొట్టుకు	కొట్టుకు
kottukuni	చెకాతో	కొట్టుకుని
kottukune	కాకావి	కొట్టుకునే
kottukunee	కొట్టుకునే	కొట్టుకునే
kottavi	కొత్తవి	కొత్తవి
kotthavi	కొత్తవి	కొత్తవి
konniti	రుచె	కొన్నిటి
konnitiki	తోజుచె	కొన్నిటికి
komaram	జు	కొమరం
komma	తో	కొమ్మ
kommalaku	జుజు	కొమ్మలకు
kommalatho	పితో	కొమ్మలతో
kommalato	రుచె	కొమ్మలతో
kommalatoo	చెతో	కొమ్మలతో
koirala	కొయిరాలా	కొయిరాలా
koyerala	రుదా	కొయిరాలా
koyiraalaa	విలే	కొయిరాలా
koradaatho	తోకా	కొరడాతో
koradaato	కొరడాతో	కొరడాతో
koradaatoo	కొరడాతో	కొరడాతో
kolamaanam	కొలమానం	కొలమానం
kolamanam	కొలమానం	కొలమానం
kolichi	పిలే	కొలిచి
cholesterol	కొలెస్టరాల్	కొలెస్టరాల్
cholestrol	రునోపి	కొలెస్టరాల్
colestaral	కొలెస్టరాల్	కొలెస్టరాల్
kolestaraal	చెపిజు	కొలెస్టరాల్
kollayi	కొల్లాయి	కొల్లాయి
koganti	కోగంటి	కోగంటి
kooganti	రువి	కోగంటి
koti	కోటి	కోటి
kotipalli	కోటిపల్లి	కోటిపల్లి
kodaligaa	వినో	కోడలిగా
koodaligaa	చెనో	కోడలిగా
kori	వి	కోరి
korika	నో	కోరిక
koorikaga	కోరికగా	కోరికగా
korikaga	కోరికగా	కోరికగా
korikagaa	లేపి	కోరికగా
korikanu	కోరికను	కోరికను
kosoori	కోసూరి	కోసూరి
kosuri	కోసూరి	కోసూరి
kosuuri	విలే	కోసూరి
caampus	రుపి	క్యాంపస్
campus	పిదా	క్యాంపస్
campuus	లేకా	క్యాంపస్
kampus	విపి	క్యాంపస్
kyaampas	క్యాంపస్	క్యాంపస్
kyamps	క్యాంపస్	క్యాంపస్
cramamu	క్రమము	క్రమము
kramamu	రుకా	క్రమము
cramamuga	పిరు	క్రమముగా
kramamuga	కాచె	క్రమముగా
kramamugaa	లేపి	క్రమముగా
criyanu	క్రియను	క్రియను
kriyanu	వితో	క్రియను
criyalaku	పిపి	క్రియలకు
kriyalaku	క్రియలకు	క్రియలకు
criyalu	నోలే	క్రియలు
kriyalu	తోజు	క్రియలు
criyalo	క్రియలో	క్రియలో
criyaloo	క్రియలో	క్రియలో
kriyalo	క్రియలో	క్రియలో
kriyaloo	పిజు	క్రియలో
cree	క్రీ	క్రీ
cri	క్రీ	క్రీ
kree	క్రీ	క్రీ
kri	చె	క్రీ
click	రుదా	క్లిక్
clicq	క్లిక్	క్లిక్
klikk	క్లిక్	క్లిక్
clear	లేతో	క్లియర్
cler	వితో	క్లియర్
klear	కానో	క్లియర్
cloud	క్లౌడ్	క్లౌడ్
clouud	రుజు	క్లౌడ్
could	క్లౌడ్	క్లౌడ్
kloud	క్లౌడ్	క్లౌడ్
ksheenata	కాజు	క్షీణత
ksheenatha	క్షీణత	క్షీణత
kshinatha	క్షీణత	క్షీణత
ksheenataku	క్షీణతకు	క్షీణతకు
kshinathaku	పికా	క్షీణతకు
ksheenataku	రునో	క్షీణతను
ksheenatanu	పిజు	క్షీణతను
ksheenathanu	చెపి	క్షీణతను
kshinathanu	జురు	క్షీణతను
kshethramu	చెచెనో	క్షేత్రము
kshetramu	చెదాజు	క్షేత్రము
kshethraminaku	లేకానోవి	క్షేత్రమునకు
kshetramunaku	క్షేత్రమునకు	క్షేత్రమునకు
kshethramaina	క్షేత్రమైన	క్షేత్రమైన
kshetramaina	క్షేత్రమైన	క్షేత్రమైన
ksheitraaniki	చెలేరుతో	క్షేత్రానికి
kshetraniki	విజుజునో	క్షేత్రానికి
ksheytraaniki	రుదాదానో	క్షేత్రానికి
ksheitraanni	తోపికాలే	క్షేత్రాన్ని
kshethraanni	జుజుచెతో	క్షేత్రాన్ని
kshetraanni	క్షేత్రాన్ని	క్షేత్రాన్ని
kshetranni	రుపిపిపి	క్షేత్రాన్ని
ksheytraanni	క్షేత్రాన్ని	క్షేత్రాన్ని
khandinchi	ఖండించి	ఖండించి
khandince	ఖండించే	ఖండించే
khandinche	ఖండించే	ఖండించే
khaidee	ఖైదీ	ఖైదీ
khaidi	రు	ఖైదీ
khaidii	కా	ఖైదీ
khaideega	పిజు	ఖైదీగా
khaidiga	ఖైదీగా	ఖైదీగా
khaidigaa	రుతో	ఖైదీగా
khaideela	ఖైదీల	ఖైదీల
khaidila	ఖైదీల	ఖైదీల
khaideelanu	ఖైదీలను	ఖైదీలను
khaidilanu	విచె	ఖైదీలను
ganguli	చెరు	గంగూలీ
ganguly	వివి	గంగూలీ
ganguulee	గంగూలీ	గంగూలీ
gantyaada	గంట్యాడ	గంట్యాడ
gantyada	దావి	గంట్యాడ
gandi	కా	గండి
gagan	కా	గగన్
gaja	గజ	గజ
gajaraaju	దాదా	గజరాజు
gajaraju	దావి	గజరాజు
gajaendhra	గజేంద్ర	గజేంద్ర
gajeendra	కావి	గజేంద్ర
gajendhra	తోతో	గజేంద్ర
gajendra	చెతో	గజేంద్ర
gadupu	చె	గడుపు
gaddalu	గడ్డలు	గడ్డలు
ganistaru	గణిస్తారు	గణిస్తారు
ganistharu	గణిస్తారు	గణిస్తారు
gabbhilam	గబ్బిలం	గబ్బిలం
gabbilam	చెకా	గబ్బిలం
garvam	గర్వం	గర్వం
garvamu	పిజు	గర్వము
galadu	చె	గలడు
galada	గలదా	గలదా
galadaa	రు	గలదా
galadhu	కా	గలదు
galadu	గలదు	గలదు
gaandhi	తో	గాంధి
gandhi	వి	గాంధి
gaayanee	గాయనీ	గాయనీ
gaayanii	నో	గాయనీ
gayani	గాయనీ	గాయనీ
gaaradee	గారడీ	గారడీ
gharadi	గారడీ	గారడీ
gaaru	జు	గారు
garu	గారు	గారు
gaavinchi	గావించి	గావించి
gavinchi	లేకా	గావించి
gundamu	చెదా	గుండము
gunam	గుణం	గుణం
guma	గుమ్మా	గుమ్మా
gumma	నోపి	గుమ్మా
gummaa	గుమ్మా	గుమ్మా
guumma	జులే	గుమ్మా
gummaalu	గుమ్మాలు	గుమ్మాలు
guruthva	లేచె	గురుత్వ
gurutva	కాచె	గురుత్వ
gurraaniki	నోతోలే	గుర్రానికి
gurraniki	గుర్రానికి	గుర్రానికి
gooni	రు	గూని
garald	చెజు	గెరాల్డ్
geraald	జురు	గెరాల్డ్
gerald	గెరాల్డ్	గెరాల్డ్
gatu	లే	గేటు
getu	రు	గేటు
gottam	గొట్టం	గొట్టం
gottamu	గొట్టము	గొట్టము
gottaanni	లేతోదా	గొట్టాన్ని
goddali	రుచె	గొడ్డలి
godla	గొడ్ల	గొడ్ల
godlla	గొడ్ల	గొడ్ల
gorre	కాదా	గొర్రె
gorrey	కాలే	గొర్రె
gorrela	చెవి	గొర్రెల
gorreyla	రుపి	గొర్రెల
gorrelu	గొర్రెలు	గొర్రెలు
gorreylu	లేకా	గొర్రెలు
golla	తో	గొల్ల
gollapalli	గొల్లపల్లి	గొల్లపల్లి
gollapoodi	విచెచె	గొల్లపూడి
gollapudi	చెచెనో	గొల్లపూడి
gollalu	కాజు	గొల్లలు
godala	లే	గోడల
goodala	గోడల	గోడల
godalatho	చెరు	గోడలతో
godalato	గోడలతో	గోడలతో
goodalathoo	గోడలతో	గోడలతో
godalalo	దావి	గోడలలో
goodalaloo	రుతో	గోడలలో
godhumalanu	గోధుమలను	గోధుమలను
gooddhimalanu	జుతో	గోధుమలను
godhumalu	గోధుమలు	గోధుమలు
gooddhumalu	గోధుమలు	గోధుమలు
goorinka	పిరు	గోరింక
gorinka	కాజు	గోరింక
goovu	లే	గోవు
govu	నో	గోవు
goovunu	గోవును	గోవును
govunu	నోతో	గోవును
goovulu	లేకా	గోవులు
govulu	కాతో	గోవులు
goosangi	తోకా	గోసంగి
gosangi	గోసంగి	గోసంగి
gautamudu	నోజు	గౌతముడు
gauthamudu	గౌతముడు	గౌతముడు
goutamudu	పిపి	గౌతముడు
gouthamudu	విలే	గౌతముడు
gowtamudu	తోనో	గౌతముడు
gautamuni	పిచె	గౌతముని
gauthamuni	గౌతముని	గౌతముని
gouthamuni	వివి	గౌతముని
gowtamuni	గౌతముని	గౌతముని
gautam	నో	గౌతమ్
gautham	రు	గౌతమ్
goutam	నో	గౌతమ్
goutham	గౌతమ్	గౌతమ్
gowtam	గౌతమ్	గౌతమ్
gramddhaalayam	కాదాలే	గ్రంథాలయం
grandhaalayam	జువివి	గ్రంథాలయం
granthaalayam	దాజువి	గ్రంథాలయం
granthalayam	నోలేనో	గ్రంథాలయం
gramddhaalayaalanu	గ్రంథాలయాలను	గ్రంథాలయాలను
grandhaalayaalanu	గ్రంథాలయాలను	గ్రంథాలయాలను
granthaalayyalanu	దాతోచెజు	గ్రంథాలయాలను
granthalayalanu	జులేకాజు	గ్రంథాలయాలను
grahastula	రుచె	గ్రస్తుల
grasthula	గ్రస్తుల	గ్రస్తుల
grastula	గ్రస్తుల	గ్రస్తుల
grahaaniki	రురువి	గ్రహానికి
grahaniki	వివిరు	గ్రహానికి
graamaala	గ్రామాల	గ్రామాల
gramala	విదా	గ్రామాల
greeshma	రులే	గ్రీష్మ
grishma	జుచె	గ్రీష్మ
grudlanu	గ్రుడ్లను	గ్రుడ్లను
gurdlanu	కావిదా	గ్రుడ్లను
greeg	గ్రెగ్	గ్రెగ్
greg	గ్రెగ్	గ్రెగ్
glain	గ్లెన్	గ్లెన్
glen	గ్లెన్	గ్లెన్
glenn	గ్లెన్	గ్లెన్
guaaraani	గ్వారని	గ్వారని
guarani	గ్వారని	గ్వారని
guuarani	చెజు	గ్వారని
ghatootkachudu	ఘటోత్కచుడు	ఘటోత్కచుడు
ghatotkachudu	విజులే	ఘటోత్కచుడు
ganibavinchi	ఘనీభవించి	ఘనీభవించి
ghanibhavinchi	దాచెజు	ఘనీభవించి
ghaniibhavinchi	విరులే	ఘనీభవించి
ganibavinchina	నోరురు	ఘనీభవించిన
ghanibhavinnchina	తోచెచె	ఘనీభవించిన
ghaniibhavinchina	ఘనీభవించిన	ఘనీభవించిన
ghoramga	విపి	ఘోరంగా
ghoramgaa	నోజు	ఘోరంగా
ghorangaa	లేపి	ఘోరంగా
goramga	ఘోరంగా	ఘోరంగా
ghosh	ఘోష్	ఘోష్
gosh	ఘోష్	ఘోష్
chacchaaru	చచ్చారు	చచ్చారు
chachhaaru	దావి	చచ్చారు
chattabaddamga	చట్టబద్దంగా	చట్టబద్దంగా
chattabaddanga	చెజునో	చట్టబద్దంగా
chattabaddangaa	చట్టబద్దంగా	చట్టబద్దంగా
chattabadhamgaa	దావిదా	చట్టబద్దంగా
chattabaddamaina	చట్టబద్దమైన	చట్టబద్దమైన
chattabaddamyna	తోరుదా	చట్టబద్దమైన
chattabaddhamaina	జుజుపి	చట్టబద్దమైన
chattabadda	చట్టబద్ధ	చట్టబద్ధ
chattabaddha	విరు	చట్టబద్ధ
chattabaddam	కాదారు	చట్టబద్ధం
chattabaddham	తోతోవి	చట్టబద్ధం
chathurdha	విపి	చతుర్ధ
chaturdha	పిదా	చతుర్ధ
chaturtha	చతుర్ధ	చతుర్ధ
chadunuga	నోచె	చదునుగా
chadhuvuthunnaaru	నోవిలేలే	చదువుతున్నారు
chaduvuthunnaru	తోనోనోలే	చదువుతున్నారు
chaduvutunaaru	నోజుచెవి	చదువుతున్నారు
chadhuvuthuu	నోరు	చదువుతూ
chaduvuthoo	పిరు	చదువుతూ
chaduvuthu	చదువుతూ	చదువుతూ
chaduvutuu	జుచె	చదువుతూ
chaddhi	దా	చద్ది
chaddi	తో	చద్ది
chappudu	విలే	చప్పుడు
caracara	లే	చరాచర
charaachara	రు	చరాచర
charita	పి	చరిత
charitha	రు	చరిత
charitamu	చరితము	చరితము
charithamu	కాతో	చరితము
caritrakarul	చరిత్రకారుల	చరిత్రకారుల
charithrakaarula	కాతోతో	చరిత్రకారుల
charithrakarula	చరిత్రకారుల	చరిత్రకారుల
caritrakarulaku	చరిత్రకారులకు	చరిత్రకారులకు
charithrakaarulaku	కాతోచెకా	చరిత్రకారులకు
charithrakarulaku	పివిరురు	చరిత్రకారులకు
caritrakarulu	చరిత్రకారులు	చరిత్రకారులు
charithrakaarulu	నోరులేతో	చరిత్రకారులు
charithrakarula	పిలేకాతో	చరిత్రకారులు
charchinchatam	విజుదా	చర్చించటం
charchinchataaniki	పిలేరుచె	చర్చించటానికి
charchinchataniki	పికాచెవి	చర్చించటానికి
charchinchadam	చర్చించడం	చర్చించడం
charchinchadaaniki	తోచెచెజు	చర్చించడానికి
charchinchadaniki	చర్చించడానికి	చర్చించడానికి
cahrchinchaaru	లేచెజు	చర్చించారు
charchinchaaru	చర్చించారు	చర్చించారు
churchincharu	జులేచె	చర్చించారు
charchinchaalani	రుపినో	చర్చించాలని
churchinchaalani	రుతోతో	చర్చించాలని
churchinchalani	రుదావి	చర్చించాలని
charchinchi	నోదా	చర్చించి
churchinchi	లేజు	చర్చించి
charchinchindhi	కాచెలే	చర్చించింది
charchinchindi	లేతోరు	చర్చించింది
churchinchindi	చర్చించింది	చర్చించింది
charchinchina	దాచెనో	చర్చించిన
churchinchina	చర్చించిన	చర్చించిన
charchinche	చర్చించే	చర్చించే
charchinchee	పికా	చర్చించే
churchinche	తోజు	చర్చించే
charchilalo	చర్చిలలో	చర్చిలలో
charchilaloo	చర్చిలలో	చర్చిలలో
churchilalo	దాలే	చర్చిలలో
charchilu	చర్చిలు	చర్చిలు
churchilu	చెవి	చర్చిలు
churchlu	చెవి	చర్చిలు
caryalatoo	పిచె	చర్యలతో
charyalatho	తోలే	చర్యలతో
charyalathoo	చర్యలతో	చర్యలతో
charyalatoo	చర్యలతో	చర్యలతో
caryalapai	చర్యలపై	చర్యలపై
charyalapai	చర్యలపై	చర్యలపై
caryalaloo	లేచె	చర్యలలో
charyalaloo	కాకా	చర్యలలో
challa	కా	చల్ల
challagaane	చల్లగానే	చల్లగానే
challagaanee	చల్లగానే	చల్లగానే
challagane	రులే	చల్లగానే
challatam	తోవి	చల్లటం
challati	చల్లటి	చల్లటి
challapalli	నోరునో	చల్లపల్లి
challi	చె	చల్లి
chavichooshaayi	పినోకా	చవిచూశాయి
chavichusai	తోనోవి	చవిచూశాయి
chavichuusaayi	తోతోపి	చవిచూశాయి
chaampian	తోనో	చాంపియన్
chaampiyan	చాంపియన్	చాంపియన్
chaanhiyan	చాంపియన్	చాంపియన్
chaanakya	తోకా	చాణక్య
chanakya	చాణక్య	చాణక్య
chaarulata	రుదా	చారులత
chaarulatha	చారులత	చారులత
chikkati	జుతో	చిక్కటి
chidatalu	జునో	చిడతలు
chidathalu	పికా	చిడతలు
chithraranga	చిత్రరంగ	చిత్రరంగ
chitraranga	చిత్రరంగ	చిత్రరంగ
chithrinchadaaniki	చిత్రించడానికి	చిత్రించడానికి
chithrinchadaniki	చిత్రించడానికి	చిత్రించడానికి
chitrikarinchadaniki	దాపిలేచె	చిత్రించడానికి
chitrinchadaaniki	రుచెచెనో	చిత్రించడానికి
chinukula	చెతో	చినుకులా
chinukulaa	నోపి	చినుకులా
chinukulu	చినుకులు	చినుకులు
chinna	వి	చిన్న
chinnathanam	చిన్నతనం	చిన్నతనం
chinnathanamlo	చిన్నతనంలోనే	చిన్నతనంలోనే
chinnathanamlone	చిన్నతనంలోనే	చిన్నతనంలోనే
chinnadhi	చిన్నది	చిన్నది
chinnadi	విపి	చిన్నది
chinnadhigaa	చెచెతో	చిన్నదిగా
chinnadiga	చిన్నదిగా	చిన్నదిగా
chinnadigaa	చిన్నదిగా	చిన్నదిగా
chinnavayasu	విదాకా	చిన్నవయసు
chillara	లేకా	చిల్లర
chihnamaina	కారు	చిహ్నమైన
chihnamyna	విపి	చిహ్నమైన
chihnaanni	చిహ్నాన్ని	చిహ్నాన్ని
chihnanni	విపిపి	చిహ్నాన్ని
chiipurupalli	చీపురుపల్లి	చీపురుపల్లి
cheelchi	చీల్చి	చీల్చి
chiilchi	దావి	చీల్చి
chilchi	కారు	చీల్చి
chuttu	చుట్టు	చుట్టు
chuttunu	పిపి	చుట్టును
chuttuu	చుట్టూ	చుట్టూ
chunnaaru	చున్నారు	చున్నారు
chunnaru	నోవి	చున్నారు
chudu	రు	చూడు
chuudu	రు	చూడు
chuddam	కాదా	చూద్దాం
chuuddaam	చూద్దాం	చూద్దాం
chusenduku	నోచెదా	చూసేందుకు
chuusaemduku	జుపివి	చూసేందుకు
chuuseenduku	తోజుపి	చూసేందుకు
chenchu	లే	చెంచు
chenchula	దాలే	చెంచులు
chenchulu	చెంచులు	చెంచులు
chendadamtho	చెందడంతో	చెందడంతో
chendhadamthoo	జుచె	చెందడంతో
chendhadamtoo	పికా	చెందడంతో
chendhinadhe	జునో	చెందినదే
chendinade	చెందినదే	చెందినదే
chendinde	చెందినదే	చెందినదే
cheda	జు	చెద
chepthu	చెప్తూ	చెప్తూ
chepthuu	లేదా	చెప్తూ
cheptoo	పిపి	చెప్తూ
cheppagala	చెప్పగల	చెప్పగల
cheppagla	లేతో	చెప్పగల
cheppagalamu	జుతోజు	చెప్పగలము
cheppaga	చెప్పగా	చెప్పగా
cheppagaa	విపి	చెప్పగా
cheppagaane	జుచెలే	చెప్పగానే
cheppagane	చెపితో	చెప్పగానే
cheppadam	నోలే	చెప్పడం
cheppamani	చెప్పమని	చెప్పమని
cheppalaykapooyaaru	చెప్పలేకపోయారు	చెప్పలేకపోయారు
cheppalekapoyaaru	రురుచెతో	చెప్పలేకపోయారు
cheppalekapoyaru	పినోతోతో	చెప్పలేకపోయారు
cheppavacchu	చెప్పవచ్చు	చెప్పవచ్చు
cheppavachchu	తోకాపి	చెప్పవచ్చు
cheppavacchunu	చెప్పవచ్చును	చెప్పవచ్చును
cheppavachchunu	విదానోజు	చెప్పవచ్చును
cheppavalasi	చెప్పవలసి	చెప్పవలసి
cheppavalasina	చెప్పవలసి	చెప్పవలసి
cheppaaru	లేతో	చెప్పారు
cheppaalani	జుచెదా	చెప్పాలని
cheppalani	వితోదా	చెప్పాలని
cheppinattu	చెప్పినట్టు	చెప్పినట్టు
cheppay	చెప్పే	చెప్పే
cheppe	చెప్పే	చెప్పే
cheraku	చెరకు	చెరకు
chellani	నోచె	చెల్లని
chellini	చెల్లని	చెల్లని
chelli	విజు	చెల్లి
chellindhi	చెల్లింది	చెల్లింది
chellindi	జులేనో	చెల్లింది
cheyllindhi	రుపిచె	చెల్లింది
chelliki	చెల్లికి	చెల్లికి
cheylliki	చెల్లికి	చెల్లికి
chellemma	లేలేరు	చెల్లెమ్మ
chelleymma	చెవితో	చెల్లెమ్మ
chelleliki	చెల్లెలికి	చెల్లెలికి
cheylleliki	నోవిపి	చెల్లెలికి
chaetu	నో	చేటు
cheetu	చె	చేటు
chetu	చేటు	చేటు
cheeyagaladu	చేయగలదు	చేయగలదు
cheyagaladu	చేయగలదు	చేయగలదు
cheeyadamloo	రుచె	చేయడంలో
cheyadamlo	లేజు	చేయడంలో
chaeyalaemu	చేయలేము	చేయలేము
cheeyaleemu	చెనో	చేయలేము
cheyalemu	చేయలేము	చేయలేము
chaeyavalasimdigaa	చేయవలసిందిగా	చేయవలసిందిగా
cheeyavalsindigaa	దావిజుకా	చేయవలసిందిగా
cheyavalasindhigaa	పిదావిపి	చేయవలసిందిగా
cheeyincha	చెవి	చేయించ
cheyincha	చేయించ	చేయించ
cheeyinchagaa	జుజు	చేయించగా
cheyinchagaa	జురు	చేయించగా
cheeyinchatam	చేయించటం	చేయించటం
cheyinchatam	లేపి	చేయించటం
cheeyinchadam	విరు	చేయించడం
cheyinchadam	చేయించడం	చేయించడం
cheeyinchaadu	చేయించాడు	చేయించాడు
cheyinchaadu	దాజుదా	చేయించాడు
chaeyimchaalani	చేయించాలని	చేయించాలని
cheeyinchaalani	కావినో	చేయించాలని
cheinchaalani	లేనోదా	చేయించాలని
chaeyimchi	చేయించి	చేయించి
cheeyinchi	కాపి	చేయించి
cheinchi	పివి	చేయించి
chaeyimchina	రుజు	చేయించిన
cheeyinchina	చెదా	చేయించిన
cheinchina	రుచె	చేయించిన
cheeyinchee	జువి	చేయించే
cheinche	రుపి	చేయించే
cheyinche	చేయించే	చేయించే
chaeyu	చేయు	చేయు
cheeyu	చేయు	చేయు
cheyu	వి	చేయు
chaeyuchu	చేయుచు	చేయుచు
cheeyuchu	చేయుచు	చేయుచు
cheyuchu	దారు	చేయుచు
chaeyunu	చేయును	చేయును
cheyunu	చేయును	చేయును
cheyuvaaru	జులే	చేయువారు
cheyuvaru	చేయువారు	చేయువారు
cheerakundaa	కాజు	చేరకుండా
cherakundaa	చేరకుండా	చేరకుండా
cheeratam	చేరటం	చేరటం
cheratam	చేరటం	చేరటం
cheeradaaniki	పిజుదా	చేరడానికి
cheradaaniki	చెరునో	చేరడానికి
chaeraa	నో	చేరా
cheeraa	దా	చేరా
chera	పి	చేరా
chaeraadani	జుకా	చేరాడని
cheeraadani	చేరాడని	చేరాడని
cheradani	పిజు	చేరాడని
chaeraaru	నోలే	చేరారు
cheeraaru	చేరారు	చేరారు
cheraru	చేరారు	చేరారు
chaerimdani	చెజు	చేరిందని
cheerindani	పిచె	చేరిందని
cherindhani	చేరిందని	చేరిందని
chaerukunna	చేరుకున్న	చేరుకున్న
cherukunna	చేరుకున్న	చేరుకున్న
chaerukunnappudu	చేరుకున్నప్పుడు	చేరుకున్నప్పుడు
cherukunnappudu	పిపిదారుజు	చేరుకున్నప్పుడు
chaerukunnaadu	జుకాజునో	చేరుకున్నాడు
cherukunnaadu	జుచెచెరు	చేరుకున్నాడు
cherukunnadu	పితోవిపి	చేరుకున్నాడు
chaerukunnaaru	చేరుకున్నారు	చేరుకున్నారు
cherukunnaaru	చేరుకున్నారు	చేరుకున్నారు
cherukunnaru	కానోరులే	చేరుకున్నారు
chaerutunna	కావిదా	చేరుతున్న
cheruthunna	కాతోరు	చేరుతున్న
chaesaaru	దాచె	చేసారు
chesaaru	దాజు	చేసారు
chesaru	జువి	చేసారు
cheesukuntaanu	చేసుకుంటాను	చేసుకుంటాను
chesukuntanu	నోచెజు	చేసుకుంటాను
cheesukommani	దానోవి	చేసుకొమ్మని
chesukommani	చేసుకొమ్మని	చేసుకొమ్మని
cheeseevi	నోపి	చేసేవి
chesevi	చేసేవి	చేసేవి
cheestaam	పిలే	చేస్తాం
chestaam	చేస్తాం	చేస్తాం
chestam	విపి	చేస్తాం
chesthaam	చేస్తాం	చేస్తాం
cheestuntaayi	లేతోరు	చేస్తుంటాయి
chesthuntaayi	చేస్తుంటాయి	చేస్తుంటాయి
chestuntayi	చేస్తుంటాయి	చేస్తుంటాయి
cheestunnappudu	రువినోరుదా	చేస్తున్నప్పుడు
chesthunnappudu	చేస్తున్నప్పుడు	చేస్తున్నప్పుడు
chestunnappudu	కాజుచెవినో	చేస్తున్నప్పుడు
cheestoondani	చెలేకా	చేస్తోందని
chesthodani	చేస్తోందని	చేస్తోందని
chestondani	పికాజు	చేస్తోందని
chaineeyula	చైనీయుల	చైనీయుల
chainiiyula	దాపి	చైనీయుల
chainiyula	రుపి	చైనీయుల
chaineeyulu	తోకా	చైనీయులు
chainiyulu	తోకా	చైనీయులు
chaneeyulu	దాజు	చైనీయులు
chootiki	చెతో	చోటికి
chotiki	చోటికి	చోటికి
chootuki	చోటుకు	చోటుకు
chotuku	కానో	చోటుకు
chootucheesukuntaayi	చోటుచేసుకుంటాయి	చోటుచేసుకుంటాయి
chotuchaesukuntaayi	లేరుదాకాకా	చోటుచేసుకుంటాయి
chotuchesukuntayi	తోజుకావివి	చోటుచేసుకుంటాయి
chootuloo	దాదా	చోటులో
chotulo	చోటులో	చోటులో
chola	పి	చోళ
choolha	చోళ	చోళ
choludu	చోళుడు	చోళుడు
choolhudu	నోలే	చోళుడు
cha	చె	ఛ
chha	ఛ	ఛ
chainel	వి	ఛానల్
chanel	ఛానల్	ఛానల్
channel	ఛానల్	ఛానల్
chalenger	దాజు	ఛాలెంజర్
challengar	ఛాలెంజర్	ఛాలెంజర్
challenger	తోతో	ఛాలెంజర్
challenjer	ఛాలెంజర్	ఛాలెంజర్
jantaku	తో	జంటకు
jaganmaata	జగన్మాత	జగన్మాత
jaganmaatha	లేకా	జగన్మాత
jaganmata	తోవి	జగన్మాత
jagityaala	జగిత్యాల	జగిత్యాల
jagityala	జుపి	జగిత్యాల
jatilamaina	జటిలమైన	జటిలమైన
japaanu	లే	జపాను
japanu	జపాను	జపాను
jamunaa	జమునా	జమునా
zamunaa	జమునా	జమునా
jayadeevudu	దారు	జయదేవుడు
jayadevudu	జయదేవుడు	జయదేవుడు
jayabheeri	జయభేరి	జయభేరి
jayabheri	రునో	జయభేరి
jarugakundaa	నోలేలే	జరుగకుండా
jaruputhoo	జురు	జరుపుతూ
jaruputhu	కాపి	జరుపుతూ
jarnalistu	వినోచె	జర్నలిస్టు
journalistu	దాదాజు	జర్నలిస్టు
jarnalistulanu	జర్నలిస్టులను	జర్నలిస్టులను
journalistulanu	చెచెజురు	జర్నలిస్టులను
germanlu	చెదా	జర్మన్లు
jarmanlu	జర్మన్లు	జర్మన్లు
jalaalu	జలాలు	జలాలు
jaagu	రు	జాగు
jagu	జాగు	జాగు
jaaj	జాజ్	జాజ్
jaazz	జాజ్	జాజ్
jajj	జాజ్	జాజ్
jazz	జాజ్	జాజ్
zazz	జు	జాజ్
jaat	జాట్	జాట్
jaateeyoodyamam	నోవినో	జాతీయోద్యమం
jaatheeyodhyamam	జాతీయోద్యమం	జాతీయోద్యమం
jaatiiyoodyamam	జాతీయోద్యమం	జాతీయోద్యమం
jatiyodyamam	జాతీయోద్యమం	జాతీయోద్యమం
jaateeyoodyamaaniki	జాతీయోద్యమానికి	జాతీయోద్యమానికి
jaatiiyoodyamaanikee	జాతీయోద్యమానికి	జాతీయోద్యమానికి
jatheeyodhyamaniki	జాతీయోద్యమానికి	జాతీయోద్యమానికి
jatiyodyamaniki	జాతీయోద్యమానికి	జాతీయోద్యమానికి
jaanapada	జానపద	జానపద
jaanapadha	జానపద	జానపద
janapada	పి	జానపద
janapadha	దా	జానపద
jaanapadam	జుతో	జానపదం
jaanapadham	జానపదం	జానపదం
janapadam	విచె	జానపదం
janapadham	జానపదం	జానపదం
jaanapadhula	జానపదుల	జానపదుల
jaanapadula	జానపదుల	జానపదుల
janapadula	నోరు	జానపదుల
janapdhula	జానపదుల	జానపదుల
jaanet	చెదా	జానెట్
janet	నోజు	జానెట్
zanet	నోకా	జానెట్
jayin	జాయిన్	జాయిన్
join	దాచె	జాయిన్
zaayin	పిచె	జాయిన్
zayin	చెపి	జాయిన్
zoin	నోవి	జాయిన్
jaaree	జారీ	జారీ
jaarii	కా	జారీ
jari	జారీ	జారీ
jaavaed	చెలే	జావేద్
jaavedh	జావేద్	జావేద్
jaawed	జావేద్	జావేద్
javed	జావేద్	జావేద్
jawed	కాతో	జావేద్
zawed	చెచె	జావేద్
jeguru	జిగురు	జిగురు
jiguru	జిగురు	జిగురు
jegurunu	కాజు	జిగురును
jigurunu	కాజు	జిగురును
jiimmy	వికా	జిమ్మీ
jimmi	నోరు	జిమ్మీ
jimmii	జిమ్మీ	జిమ్మీ
jimmy	జిమ్మీ	జిమ్మీ
jimy	విజు	జిమ్మీ
zimmy	రుతో	జిమ్మీ
giraffe	జిరాఫీ	జిరాఫీ
jiraafii	దాతో	జిరాఫీ
jiraaphii	చెపి	జిరాఫీ
jirafi	జురు	జిరాఫీ
gene	లే	జీన్
jean	కా	జీన్
jeen	పి	జీన్
jen	జీన్	జీన్
jene	రు	జీన్
jiin	జీన్	జీన్
zean	లే	జీన్
jeans	కారు	జీన్స్
jeens	రునో	జీన్స్
jeense	పిచె	జీన్స్
jiins	వివి	జీన్స్
zeans	రుజు	జీన్స్
junior	జూనియర్	జూనియర్
juunior	జూనియర్	జూనియర్
zunior	జూనియర్	జూనియర్
juniors	చెకాకా	జూనియర్స్
juniyars	విజుపి	జూనియర్స్
juuniors	తోనోకా	జూనియర్స్
zuniors	కారుకా	జూనియర్స్
zuniyars	వికానో	జూనియర్స్
jetti	జెట్టి	జెట్టి
gen	కా	జెన్
jen	కా	జెన్
zen	జు	జెన్
jennee	లేలే	జెన్నీ
jenni	జెన్నీ	జెన్నీ
jenny	జెన్నీ	జెన్నీ
jeny	తోలే	జెన్నీ
zenny	జెన్నీ	జెన్నీ
gessi	జెస్సీ	జెస్సీ
jesse	జుజు	జెస్సీ
jessee	జెస్సీ	జెస్సీ
jessi	జెస్సీ	జెస్సీ
jessie	నోనో	జెస్సీ
jessiie	పిరు	జెస్సీ
zesse	పిరు	జెస్సీ
zessie	జెస్సీ	జెస్సీ
jebu	కా	జేబు
jebulo	జేబులో	జేబులో
jeyu	జేయు	జేయు
jyaeshta	జ్యేష్ఠ	జ్యేష్ఠ
jyeeshtha	విరు	జ్యేష్ఠ
jyeshtha	జ్యేష్ఠ	జ్యేష్ఠ
jyesta	దారు	జ్యేష్ఠ
jyoothisha	జ్యోతిష	జ్యోతిష
jyootisha	పిదా	జ్యోతిష
jyoothsna	జ్యోత్స్న	జ్యోత్స్న
jyootsna	తోలేపి	జ్యోత్స్న
jyotsna	జ్యోత్స్న	జ్యోత్స్న
jvaramthoo	దాలే	జ్వరంతో
jvaramtoo	పితో	జ్వరంతో
tarm	తో	టర్మ్
term	టర్మ్	టర్మ్
toy	పి	టాయి
toyi	జు	టాయి
toilet	జుజు	టాయిలెట్
ticket	టికెట్	టికెట్
ticqet	జురు	టికెట్
tikket	టికెట్	టికెట్
ticketlanu	టికెట్లను	టికెట్లను
tim	వి	టిమ్
timm	టిమ్	టిమ్
teacher	టీచరు	టీచరు
teacheru	రు	టీచరు
teecharu	వి	టీచరు
teacharugaa	జురు	టీచరుగా
teacherugaa	టీచరుగా	టీచరుగా
teecharugaa	టీచరుగా	టీచరుగా
teacherlaku	పిదా	టీచర్లకు
teecharlaku	దాపి	టీచర్లకు
ten	టెన్	టెన్
tarrorism	టెర్రరిజం	టెర్రరిజం
terorism	టెర్రరిజం	టెర్రరిజం
terrarijam	టెర్రరిజం	టెర్రరిజం
terrarism	చెదాతో	టెర్రరిజం
terrorism	రుదాచె	టెర్రరిజం
testunu	టెస్టును	టెస్టును
takeeoveer	టేకోవర్	టేకోవర్
takeovar	కానో	టేకోవర్
takeover	టేకోవర్	టేకోవర్
taqeover	కాదా	టేకోవర్
taimar	కా	టైమర్
timar	వి	టైమర్
timer	టైమర్	టైమర్
toranto	పిపి	టొరంటో
torantoo	విదా	టొరంటో
toronto	టొరంటో	టొరంటో
torontoe	పివి	టొరంటో
traavel	ట్రావెల్	ట్రావెల్
travel	ట్రావెల్	ట్రావెల్
tvittar	లేదాచె	ట్విట్టర్
twiter	ట్విట్టర్	ట్విట్టర్
twittar	చెనోచె	ట్విట్టర్
twitter	రుతోతో	ట్విట్టర్
daallaas	విచె	డల్లాస్
dalas	డల్లాస్	డల్లాస్
dallaas	కారు	డల్లాస్
dallas	విదా	డల్లాస్
daam	వి	డాం
dam	డాం	డాం
daaktaru	డాక్టరు	డాక్టరు
doctoru	డాక్టరు	డాక్టరు
daaktarugaa	డాక్టరుగా	డాక్టరుగా
doctorugaa	నోచెపి	డాక్టరుగా
daaktarunu	చెతోనో	డాక్టరును
doctorlanu	తోజుతో	డాక్టరును
doctorunu	డాక్టరును	డాక్టరును
daanube	చెరు	డానుబే
danube	డానుబే	డానుబే
danuube	డానుబే	డానుబే
dick	కా	డిక్
dicq	డిక్	డిక్
dik	తో	డిక్
dikk	తో	డిక్
degreela	రుజు	డిగ్రీల
depaarture	డిపార్చర్	డిపార్చర్
departchar	నోరురు	డిపార్చర్
departure	చెదాకా	డిపార్చర్
dim	డిమ్	డిమ్
delhi	డిల్లీ	డిల్లీ
dillee	డిల్లీ	డిల్లీ
dilli	పిరు	డిల్లీ
discount	డిస్కౌంట్	డిస్కౌంట్
diskount	లేకారు	డిస్కౌంట్
deelks	డీలక్స్	డీలక్స్
delaks	డీలక్స్	డీలక్స్
delukse	డీలక్స్	డీలక్స్
delux	నోచె	డీలక్స్
deluxe	చెజు	డీలక్స్
deal	డీల్	డీల్
deel	తో	డీల్
del	నో	డీల్
death	డెత్	డెత్
deth	రు	డెత్
dailaag	డైలాగ్	డైలాగ్
diaalog	డైలాగ్	డైలాగ్
dialog	డైలాగ్	డైలాగ్
dialogue	డైలాగ్	డైలాగ్
domain	డొమైన్	డొమైన్
domen	కాచె	డొమైన్
damarukam	తోతో	ఢమరుకం
dhamarukam	కాచె	ఢమరుకం
delhi	ఢిల్లీ	ఢిల్లీ
dhillii	ఢిల్లీ	ఢిల్లీ
dhullii	రురు	ఢిల్లీ
delhiki	రునో	ఢిల్లీకి
dhilliiki	వినో	ఢిల్లీకి
delhini	తోచె	ఢిల్లీని
dhelleeni	పివి	ఢిల్లీని
dhilliini	నోకా	ఢిల్లీని
taginanta	తగినంత	తగినంత
thaginantha	తగినంత	తగినంత
taginavi	చెతో	తగినవి
thaginavi	తగినవి	తగినవి
tatti	లే	తట్టి
thatti	తో	తట్టి
tattu	వి	తట్టు
thattu	తట్టు	తట్టు
tattukunae	దాలేవి	తట్టుకునే
thattukune	తట్టుకునే	తట్టుకునే
tadichi	లే	తడిచి
thadichi	వి	తడిచి
tatvavaetta	తత్వవేత్త	తత్వవేత్త
thathvavetha	తత్వవేత్త	తత్వవేత్త
thathvavettha	జుతోతో	తత్వవేత్త
tatvavaettagaa	తత్వవేత్తగా	తత్వవేత్తగా
tatvavettaga	తోకాజు	తత్వవేత్తగా
thathvavethaga	నోవిజు	తత్వవేత్తగా
tatvavaettalu	తత్వవేత్తలు	తత్వవేత్తలు
tatvavettalu	జునోచె	తత్వవేత్తలు
thathvavethalu	తత్వవేత్తలు	తత్వవేత్తలు
tadanamtara	తదనంతర	తదనంతర
tadanantara	తదనంతర	తదనంతర
taditarulatho	తదితరులతో	తదితరులతో
taditarulatoe	దాజురు	తదితరులతో
taditarulanu	విజురు	తదితరులను
tanaku	నో	తనకూ
tanakuu	తనకూ	తనకూ
thanakuu	తనకూ	తనకూ
tanaviga	తనవిగా	తనవిగా
thanaviga	తోరు	తనవిగా
tanikhee	పి	తనిఖీ
tanikhi	తనిఖీ	తనిఖీ
tanikhii	పి	తనిఖీ
tanikheelu	లేవి	తనిఖీలు
tanikhiilu	నోపి	తనిఖీలు
tanikhilu	తనిఖీలు	తనిఖీలు
tannina	తన్నిన	తన్నిన
thannina	తన్నిన	తన్నిన
tappadu	తప్పదు	తప్పదు
tappinchu	దాపి	తప్పించు
thappinchu	తప్పించు	తప్పించు
tamaku	తమకు	తమకు
thamaku	వి	తమకు
tayaru	తయరు	తయరు
thayaru	వి	తయరు
tayaaridaarulu	తయారీదారులు	తయారీదారులు
thayaaniidhaarulu	తయారీదారులు	తయారీదారులు
thayaridarulu	పినోతో	తయారీదారులు
thayaaraithee	విజు	తయారైతే
thayaaryteyy	వినో	తయారైతే
tayaraina	తయారైన	తయారైన
thayaaraina	తయారైన	తయారైన
thayaaryna	జువి	తయారైన
tara	తర	తర
thara	రు	తర
taragaalanu	కాకా	తరంగాలను
tarangalanu	తరంగాలను	తరంగాలను
tharamgaalanu	తరంగాలను	తరంగాలను
taranginhi	నోలే	తరంగిణి
tarangini	విలే	తరంగిణి
tharamgini	జులే	తరంగిణి
taraalu	తరాలు	తరాలు
taralu	లే	తరాలు
tharaalu	వి	తరాలు
tarimchina	పిలే	తరించిన
tarinchina	పిదా	తరించిన
tharuvaathi	కాతో	తరువాతి
tharka	తర్క	తర్క
tarkaanni	చెరుచె	తర్కాన్ని
tharkaanni	చెతోచె	తర్కాన్ని
thalapimchey	దాలే	తలపించే
thalapinche	తోచె	తలపించే
thalapinchee	జువి	తలపించే
thaleththi	తలెత్తి	తలెత్తి
thaletthi	తలెత్తి	తలెత్తి
tavvimchina	జుపిజు	తవ్వించిన
thavvinchina	తవ్వించిన	తవ్వించిన
tavvina	చెనో	తవ్విన
thavvina	తవ్విన	తవ్విన
tavvae	తవ్వే	తవ్వే
thavve	వి	తవ్వే
taamdava	తాండవ	తాండవ
taandava	లే	తాండవ
thaandava	పి	తాండవ
taagadam	తో	తాగడం
thaagadam	తాగడం	తాగడం
taagadaaniki	విదారు	తాగడానికి
thaagadaaniki	తాగడానికి	తాగడానికి
taagaalani	లేతో	తాగాలని
thaagaalani	తాగాలని	తాగాలని
taagindi	తాగింది	తాగింది
thaagimdi	నోపి	తాగింది
thaagindhi	తాగింది	తాగింది
taagubotula	తాగుబోతుల	తాగుబోతుల
thaaguboothula	నోనోతో	తాగుబోతుల
thaagubothula	తాగుబోతుల	తాగుబోతుల
taati	దా	తాటి
thaati	తాటి	తాటి
taatipuudi	కాజు	తాటిపూడి
thaatipoodi	పికా	తాటిపూడి
taataaraavu	వినో	తాతారావు
thaathaaraavu	తాతారావు	తాతారావు
thaathaaravu	జుచె	తాతారావు
taanugaa	తానుగా	తానుగా
thaanugaa	తానుగా	తానుగా
taanunu	తానును	తానును
thaanunu	తానును	తానును
taamaraaku	తామరాకు	తామరాకు
thaamaraaku	చెచె	తామరాకు
taamugaa	తాముగా	తాముగా
thaamugaa	తాముగా	తాముగా
taaranu	చె	తారను
thaaranu	తారను	తారను
taaralaku	కాజు	తారలకు
thaaralaku	తారలకు	తారలకు
taaralu	తో	తారలు
thaaralu	తారలు	తారలు
taaralugaa	తారలుగా	తారలుగా
thaaralugaa	వికా	తారలుగా
thaalib	తాలిబ్	తాలిబ్
taalhapatra	తాళపత్ర	తాళపత్ర
thaalapathra	కాదా	తాళపత్ర
thiththula	తిత్తుల	తిత్తుల
thitthula	కాకా	తిత్తుల
tittula	తిత్తుల	తిత్తుల
thippagaanae	రుపితో	తిప్పగానే
thippagaane	జునోవి	తిప్పగానే
thippagaanee	తోదాచె	తిప్పగానే
thippadam	లేనో	తిప్పడం
tippadam	తిప్పడం	తిప్పడం
thippalu	తోవి	తిప్పలు
tippalu	లేరు	తిప్పలు
thippaali	లేరు	తిప్పాలి
tippaali	తిప్పాలి	తిప్పాలి
thippindhi	తిప్పింది	తిప్పింది
tippindi	కాతోదా	తిప్పింది
thippina	కాతో	తిప్పిన
tippina	తిప్పిన	తిప్పిన
thimmana	చెరు	తిమ్మన
timmana	నోపి	తిమ్మన
thiruppaavai	తిరుప్పావై	తిరుప్పావై
tiruppavy	తిరుప్పావై	తిరుప్పావై
theerakundaa	పిలే	తీరకుండా
therakundaa	దాజు	తీరకుండా
theeraa	తీరా	తీరా
theeraaniki	తీరానికి	తీరానికి
theeraanni	తీరాన్ని	తీరాన్ని
theeraala	తీరాల	తీరాల
theerala	లే	తీరాల
theerindhi	కాతో	తీరింది
theerindi	తీరింది	తీరింది
thirindi	పినో	తీరింది
tirindi	లేరు	తీరింది
theerina	తీరిన	తీరిన
thirina	తీరిన	తీరిన
tirina	దా	తీరిన
teesiveyadaaniki	దాదాపికా	తీసివేయడానికి
teesiveyadaniki	తీసివేయడానికి	తీసివేయడానికి
theesiveyadaaniki	నోజురుదా	తీసివేయడానికి
theesiveyadaniki	విపిచెతో	తీసివేయడానికి
theesukookandi	తీసుకోండి	తీసుకోండి
tiisukoemdi	తోలేదా	తీసుకోండి
tisukondi	జుదాదా	తీసుకోండి
theesukookundaa	కాచెచె	తీసుకోకుండా
tiisukoekumdaa	రుకాపి	తీసుకోకుండా
tisukokunda	విరులే	తీసుకోకుండా
theesukoogaa	తీసుకోగా	తీసుకోగా
tiisukoegaa	తీసుకోగా	తీసుకోగా
tisukoga	చెరు	తీసుకోగా
theesukoogaanee	చెదాదా	తీసుకోగానే
thisukogaane	తీసుకోగానే	తీసుకోగానే
tisukogaane	తీసుకోగానే	తీసుకోగానే
tisukogane	విజునో	తీసుకోగానే
teesukovalasi	తీసుకోవలసి	తీసుకోవలసి
theesukoovalasi	తీసుకోవలసి	తీసుకోవలసి
tiisukoevalasi	దాదారు	తీసుకోవలసి
thurumu	జులే	తురుము
turumu	నోనో	తురుము
tegi	కా	తెగి
thegi	తెగి	తెగి
teranu	తెరను	తెరను
terapaina	తెరపైన	తెరపైన
terameediki	కాజుజు	తెరమీదికి
teramidaki	తెరమీదికి	తెరమీదికి
teramiidiki	లేనోనో	తెరమీదికి
telamgaanha	లేపి	తెలంగాణ
telangana	తోచె	తెలంగాణ
telamgaanham	చెనో	తెలంగాణం
telanganam	లేతో	తెలంగాణం
telamgaanhaku	తెలంగాణకు	తెలంగాణకు
telanganaku	తెలంగాణకు	తెలంగాణకు
telamgaanhanu	తెలంగాణను	తెలంగాణను
telangananu	తెలంగాణను	తెలంగాణను
telangaanaa	తెలంగాణా	తెలంగాణా
telangana	తెలంగాణా	తెలంగాణా
telanganaa	రులే	తెలంగాణా
thelangaanaa	తెలంగాణా	తెలంగాణా
telipae	తెలిపే	తెలిపే
telipe	తెలిపే	తెలిపే
telusu	జుపి	తెలుసు
thelusu	తెలుసు	తెలుసు
thelusukoovatam	కావిరు	తెలుసుకోవటం
thelusukovatam	తెలుసుకోవటం	తెలుసుకోవటం
thelusukoovaalanukune	కానోరుతోజు	తెలుసుకోవాలనుకునే
thelusukoovaalanukunee	తెలుసుకోవాలనుకునే	తెలుసుకోవాలనుకునే
thelusukovaalanukunae	లేరుజుజుతో	తెలుసుకోవాలనుకునే
tejaswini	తేజస్విని	తేజస్విని
thaejaswini	తేజస్విని	తేజస్విని
theejasvini	దాదాలే	తేజస్విని
thejasvini	తేజస్విని	తేజస్విని
teeta	తేట	తేట
thaeta	తేట	తేట
theta	తేట	తేట
teedaaga	తోనో	తేడాగా
thaedaagaa	తేడాగా	తేడాగా
thedaagaa	తేడాగా	తేడాగా
teedaala	తేడాల	తేడాల
thedaala	వి	తేడాల
teelchadam	చెజు	తేల్చడం
telchadam	తేల్చడం	తేల్చడం
thelchadam	తేల్చడం	తేల్చడం
teelchaali	తేల్చాలి	తేల్చాలి
telchali	తేల్చాలి	తేల్చాలి
thelchali	రుపి	తేల్చాలి
teelchindi	తేల్చింది	తేల్చింది
telchindi	రులేచె	తేల్చింది
thelchindi	తేల్చింది	తేల్చింది
tevadam	చె	తేవడం
theevadam	తేవడం	తేవడం
thevadam	కా	తేవడం
taittiriiya	తైత్తిరీయ	తైత్తిరీయ
taittiriya	తైత్తిరీయ	తైత్తిరీయ
thaittireeya	తైత్తిరీయ	తైత్తిరీయ
tholinaalhlhaloo	తొలినాళ్ళలో	తొలినాళ్ళలో
tolinaalhlhaloe	జుజుకా	తొలినాళ్ళలో
tolinallalo	చెపితో	తొలినాళ్ళలో
thoodeellhu	తోడేళ్ళ	తోడేళ్ళ
todaelhlha	పిదా	తోడేళ్ళ
todella	తోతో	తోడేళ్ళ
thooluku	వికా	తోలుకు
toeluku	కారు	తోలుకు
toluku	దాలే	తోలుకు
thoolubommalaata	వివికాలే	తోలుబొమ్మలాట
toelubommalaata	తోలుబొమ్మలాట	తోలుబొమ్మలాట
tolubommalata	తోలుబొమ్మలాట	తోలుబొమ్మలాట
thyaagam	తోపి	త్యాగం
tyaagam	లేరు	త్యాగం
tyagam	పిపి	త్యాగం
thravvakam	రువి	త్రవ్వకం
travvakam	త్రవ్వకం	త్రవ్వకం
dhaaman	దా	థమన్
dhaman	లే	థమన్
thaman	రు	థమన్
dagaa	కా	దగా
daggarloeni	దగ్గర్లోని	దగ్గర్లోని
daggarlooni	రుజులే	దగ్గర్లోని
dattaatraeya	చెకాలే	దత్తాత్రేయ
dattaatreeya	దత్తాత్రేయ	దత్తాత్రేయ
dattaatreya	దత్తాత్రేయ	దత్తాత్రేయ
dattaatraeyudu	దత్తాత్రేయుడు	దత్తాత్రేయుడు
dattaatreeyudu	దత్తాత్రేయుడు	దత్తాత్రేయుడు
dattaatreyudu	దత్తాత్రేయుడు	దత్తాత్రేయుడు
dadhichi	దధీచి	దధీచి
dadhiichi	రు	దధీచి
dhadheechi	లే	దధీచి
dayaanamda	దయానంద	దయానంద
dayaananda	లేరు	దయానంద
dhayaananda	చెలే	దయానంద
dayyaalu	నోకా	దయ్యాలు
dayyalu	జువి	దయ్యాలు
dargee	దర్జీ	దర్జీ
darjee	దర్జీ	దర్జీ
darjii	దర్జీ	దర్జీ
dharjee	దర్జీ	దర్జీ
darpanam	రుచె	దర్పణం
darpanham	లేజు	దర్పణం
dharpanam	నోకా	దర్పణం
darbaaru	వితో	దర్బారు
dharbaaru	తోలే	దర్బారు
darsanaaniki	దర్శనానికి	దర్శనానికి
darshanaaniki	దర్శనానికి	దర్శనానికి
dharsanaaniki	దర్శనానికి	దర్శనానికి
darsanaanni	దర్శనాన్ని	దర్శనాన్ని
darshanaani	పిజువి	దర్శనాన్ని
dharsanaanni	దర్శనాన్ని	దర్శనాన్ని
darshi	చె	దర్శి
darsi	దర్శి	దర్శి
dharsi	పి	దర్శి
dal	దళ్	దళ్
dhal	దళ్	దళ్
davada	దవడ	దవడ
dhavada	దవడ	దవడ
davadalu	లే	దవడలు
dhavadalu	దవడలు	దవడలు
dasaku	జు	దశకు
dhashaku	జు	దశకు
dasaluga	కాలే	దశలుగా
dasalugaa	దశలుగా	దశలుగా
dhasalugaa	పిలే	దశలుగా
dasaabdaalu	పిచెచె	దశాబ్దాలు
dasabdalu	కాజుపి	దశాబ్దాలు
dhashaabdhaalu	దశాబ్దాలు	దశాబ్దాలు
dampatya	దాంపత్య	దాంపత్య
dhaampatya	దాంపత్య	దాంపత్య
daadi	దాడి	దాడి
dhadi	జు	దాడి
daadiki	తోకా	దాడికి
dhadiki	దాడికి	దాడికి
daadigaa	దాడిగా	దాడిగా
dhadiga	చెతో	దాడిగా
daaditho	జురు	దాడితో
daadithoo	దాడితో	దాడితో
daadito	రుజు	దాడితో
dhadito	దాడితో	దాడితో
daadilo	దాడిలో	దాడిలో
daadiloo	కావి	దాడిలో
dhadilo	జునో	దాడిలో
daatalu	దాతలు	దాతలు
daathalu	వి	దాతలు
daadar	తో	దాదర్
daadarr	దాదర్	దాదర్
daariki	దారికి	దారికి
dhaariki	నోపి	దారికి
daaridrya	తోలేతో	దారిద్య్ర
dhaaridhrya	దారిద్య్ర	దారిద్య్ర
daarina	నో	దారిన
dhaarina	దారిన	దారిన
daarilo	జులే	దారిలో
daariloo	దారిలో	దారిలో
darilo	దారిలో	దారిలో
daariloni	నోకా	దారిలోని
daarilooni	తోనో	దారిలోని
dariloni	దారిలోని	దారిలోని
daarilone	తోనో	దారిలోనే
daariloone	చెవి	దారిలోనే
darilone	తోకా	దారిలోనే
daarudu	దారుడు	దారుడు
darudu	దారుడు	దారుడు
daar	రు	దార్
daarr	లే	దార్
dar	దార్	దార్
daasee	పి	దాసీ
daasii	చె	దాసీ
dhaasee	కా	దాసీ
dhaasi	దాసీ	దాసీ
dhaasie	రు	దాసీ
daasoohum	నోతో	దాసోహం
dhaasoham	నోతో	దాసోహం
dhaasooham	దారు	దాసోహం
digadam	రు	దిగడం
dhigabadina	పిపి	దిగబడిన
digabadina	దిగబడిన	దిగబడిన
dhigaadu	లేజు	దిగాడు
digaadu	జుజు	దిగాడు
dhigaaru	దిగారు	దిగారు
digaaru	దిగారు	దిగారు
dhigindhi	దిగింది	దిగింది
digindhi	పిచె	దిగింది
digindi	చెవి	దిగింది
dhigudu	దాలే	దిగుడు
digudu	లేరు	దిగుడు
dhitta	రు	దిట్ట
ditta	జు	దిట్ట
dattamgaa	తోజు	దిట్టంగా
dhittangaa	దిట్టంగా	దిట్టంగా
dittamga	దిట్టంగా	దిట్టంగా
dhivaan	దివాన్	దివాన్
divaan	దాకా	దివాన్
divan	దివాన్	దివాన్
divya	జు	దివ్య
dhivyabhaarathi	పిపినో	దివ్యభారతి
divyabharathi	తోచెలే	దివ్యభారతి
divyabharati	దివ్యభారతి	దివ్యభారతి
dhivyamaina	తోతో	దివ్యమైన
divyamaina	దివ్యమైన	దివ్యమైన
divyamyna	దివ్యమైన	దివ్యమైన
dhishaa	దిశా	దిశా
disa	దిశా	దిశా
dishaa	నో	దిశా
deeniki	దీనికి	దీనికి
dheeniki	దీనికి	దీనికి
deepala	దీపాల	దీపాల
dheepaala	చె	దీపాల
diipaala	కా	దీపాల
deepaalathoo	దీపాలతో	దీపాలతో
deepalato	దీపాలతో	దీపాలతో
dheepaalatho	జువి	దీపాలతో
duppulu	దుప్పులు	దుప్పులు
dhusthithi	దుస్థితి	దుస్థితి
dusthithi	జురు	దుస్థితి
dusthiti	దుస్థితి	దుస్థితి
dhooki	దూకి	దూకి
dhuki	దా	దూకి
dooki	దూకి	దూకి
duki	లే	దూకి
dhoopa	కా	దూప
dhupa	దా	దూప
dhrukkonam	పికా	దృక్కోణం
drukkonam	లేవి	దృక్కోణం
drukkoonam	వికా	దృక్కోణం
debbathinna	దెబ్బతిన్న	దెబ్బతిన్న
dhebbathinna	దెబ్బతిన్న	దెబ్బతిన్న
debbathinnadi	పిదాదాతో	దెబ్బతిన్నది
dhebbathinnadhi	రుచెపిరు	దెబ్బతిన్నది
daeniki	దాపి	దేనికి
deeniki	దేనికి	దేనికి
deniki	జుపి	దేనికి
daenigurimchainaa	దేనిగురించైనా	దేనిగురించైనా
deenigurinchainaa	జుజుచెజు	దేనిగురించైనా
denigurinchaina	దావిరుదా	దేనిగురించైనా
daeniloenuu	దేనిలోనూ	దేనిలోనూ
deeniloonuu	జుచె	దేనిలోనూ
denilonu	జువి	దేనిలోనూ
daennii	తోచె	దేన్నీ
deennee	దేన్నీ	దేన్నీ
denni	చెనో	దేన్నీ
deevathalu	దాకా	దేవతలు
devatalu	దేవతలు	దేవతలు
devathalu	జువి	దేవతలు
deevaalayam	దేవాలయం	దేవాలయం
devalayam	లేపి	దేవాలయం
dheevaalayam	లేనో	దేవాలయం
deevaalayampai	దేవాలయంపై	దేవాలయంపై
devalayampai	చెలేదా	దేవాలయంపై
dheevaalayampai	దేవాలయంపై	దేవాలయంపై
deevaalayamlooni	దేవాలయంలోని	దేవాలయంలోని
devalayamloni	విపిదా	దేవాలయంలోని
dheevaalayamlooni	నోతోలే	దేవాలయంలోని
deevaalayamunu	లేవిపి	దేవాలయమును
devalayamunu	దావిజు	దేవాలయమును
dheevaalayamunu	పిరులే	దేవాలయమును
deevaalayamulu	వినోలే	దేవాలయములు
devaalayamulu	దేవాలయములు	దేవాలయములు
dheevaalayamulu	లేరురు	దేవాలయములు
deeshamunaku	దాచె	దేశమునకు
desamunaku	దేశమునకు	దేశమునకు
deshamunaku	దేశమునకు	దేశమునకు
deeshamaina	రుపి	దేశమైన
desamaina	దేశమైన	దేశమైన
deshamaina	తోనో	దేశమైన
deeshaanni	నోనో	దేశాన్ని
desanni	తోచె	దేశాన్ని
dheshaanni	కాపి	దేశాన్ని
deeshaabhivruddiki	పినోపితో	దేశాభివృద్ధికి
deshaabhivrhuddhiki	పితోపితో	దేశాభివృద్ధికి
dheshaabhivruddhiki	దావిలేజు	దేశాభివృద్ధికి
deeshi	దేశి	దేశి
dheshi	దేశి	దేశి
dongaku	పిరు	దొంగకు
dongaga	దొంగగా	దొంగగా
dongagaa	దొంగగా	దొంగగా
dongatanaala	దొంగతనాల	దొంగతనాల
dongatanala	జులే	దొంగతనాల
dongathanaala	దొంగతనాల	దొంగతనాల
dongani	దొంగని	దొంగని
dongala	విచె	దొంగలా
dongalaa	చెవి	దొంగలా
dongalu	దొంగలు	దొంగలు
donga	దొంగా	దొంగా
dongaa	లే	దొంగా
doopidii	నోలే	దోపిడీ
dopidee	నోచె	దోపిడీ
dopidi	దోపిడీ	దోపిడీ
doopidiiki	కాలే	దోపిడీకి
dopideeki	జుతో	దోపిడీకి
dopidiki	దాలే	దోపిడీకి
doopideeni	దోపిడీని	దోపిడీని
doopidiini	రుపి	దోపిడీని
dopidini	వినో	దోపిడీని
doopideelu	జుదా	దోపిడీలు
doopidiilu	దోపిడీలు	దోపిడీలు
dopideelu	కాచె	దోపిడీలు
dravida	చెదా	ద్రవిడ
dravid	ద్రవిడ్	ద్రవిడ్
dhraakshaloo	కాతోలే	ద్రాక్షలో
drakshalo	ద్రాక్షలో	ద్రాక్షలో
drupaduni	నోచెలే	ద్రుపదుని
draupathi	ద్రౌపతి	ద్రౌపతి
draupati	లేలే	ద్రౌపతి
droupathi	ద్రౌపతి	ద్రౌపతి
draoupadito	దాచెనో	ద్రౌపదితో
draupadithoo	ద్రౌపదితో	ద్రౌపదితో
draupadito	జుజుదా	ద్రౌపదితో
droupaditho	నోదారు	ద్రౌపదితో
draupadini	ద్రౌపదిని	ద్రౌపదిని
droupadini	ద్రౌపదిని	ద్రౌపదిని
dvaarakaa	చెనో	ద్వారకా
dwaarakaa	పికా	ద్వారకా
dwaraka	ద్వారకా	ద్వారకా
dveepa	కా	ద్వీప
dvepa	ద్వీప	ద్వీప
dvipa	ద్వీప	ద్వీప
dweepa	ద్వీప	ద్వీప
dveepanni	లేదావి	ద్వీపాన్ని
dvepanni	దాతోలే	ద్వీపాన్ని
dvipanni	ద్వీపాన్ని	ద్వీపాన్ని
dweepanni	నోజుపి	ద్వీపాన్ని
dhanika	జు	ధనిక
dhanikudu	ధనికుడు	ధనికుడు
dhanikula	లేదా	ధనికుల
danunjaya	పివి	ధనుంజయ
dhanunjaya	ధనుంజయ	ధనుంజయ
daratho	తో	ధరతో
dharatho	ధరతో	ధరతో
dharato	లే	ధరతో
daranu	ధరను	ధరను
dharanu	ధరను	ధరను
daralu	ధరలు	ధరలు
dharalu	తో	ధరలు
daralo	ధరలో	ధరలో
dharalo	ధరలో	ధరలో
dharisthoo	ధరిస్తూ	ధరిస్తూ
dharistu	విజు	ధరిస్తూ
darmapuri	చెవి	ధర్మపురి
dharmapuri	ధర్మపురి	ధర్మపురి
dhaanya	ధాన్య	ధాన్య
dhanya	ధాన్య	ధాన్య
dhaanyam	తోలే	ధాన్యం
dhanyam	కాకా	ధాన్యం
dhaanyamunu	పిరుతో	ధాన్యమును
dhanyamunu	పిచెపి	ధాన్యమును
dhaarmika	నోలే	ధార్మిక
dharmika	ధార్మిక	ధార్మిక
dhikkarimchi	ధిక్కరించి	ధిక్కరించి
dhikkarinchi	కానోకా	ధిక్కరించి
dhairya	ధైర్య	ధైర్య
dhairyam	ధైర్యం	ధైర్యం
dhairyamu	ధైర్యము	ధైర్యము
dhairyaaniki	పిచెరు	ధైర్యానికి
dhairyaniki	చెతోవి	ధైర్యానికి
dhoovathi	రు	ధోవతి
dhoovati	జు	ధోవతి
dhovathi	వి	ధోవతి
dhoumyudu	పిపి	ధౌమ్యుడు
dhyaanamu	జులే	ధ్యానము
dhyanamu	పిలే	ధ్యానము
dhyaanaanni	ధ్యానాన్ని	ధ్యానాన్ని
dhyananni	ధ్యానాన్ని	ధ్యానాన్ని
dhaninchi	తోలేలే	ధ్యానించి
dhyaaninchi	దాదాదా	ధ్యానించి
dhaninchuchu	లేదారు	ధ్యానించుచు
dhyaaninchuchu	పికాచె	ధ్యానించుచు
nandhuku	దాలే	నందుకు
nanduku	చెలే	నందుకు
nagaraallo	నోకా	నగరాల్లో
nagarallo	నగరాల్లో	నగరాల్లో
nacchi	నచ్చి	నచ్చి
nachhi	తో	నచ్చి
nachi	నచ్చి	నచ్చి
nacchae	చె	నచ్చే
nachee	చె	నచ్చే
nachhe	నచ్చే	నచ్చే
natisthoone	పితోపి	నటిస్తూనే
natisthune	రువిరు	నటిస్తూనే
natistoone	రునోతో	నటిస్తూనే
natistuunee	జుకారు	నటిస్తూనే
nateemanulu	రుచె	నటీమణులు
natiimanulu	పిరు	నటీమణులు
natimanulu	నటీమణులు	నటీమణులు
natulu	తో	నటులు
nadachi	నడచి	నడచి
nadachina	రు	నడచిన
nadavadaaniki	నడవడానికి	నడవడానికి
nadavadaniki	విపిచె	నడవడానికి
nadimi	నడిమి	నడిమి
naduchu	దా	నడుచు
nadhini	లే	నదిని
nadini	నదిని	నదిని
nadhilooki	నదిలోకి	నదిలోకి
nadiloki	కాలే	నదిలోకి
namoonaagaa	రునో	నమూనాగా
namunaga	కాలే	నమూనాగా
namuunaagaa	నమూనాగా	నమూనాగా
namoonaala	నోజు	నమూనాల
namunala	చెవి	నమూనాల
namuunaala	తోతో	నమూనాల
namoonaalanu	నమూనాలను	నమూనాలను
namunalanu	పిరు	నమూనాలను
namuunaalanu	రులే	నమూనాలను
namoonaalu	లేదా	నమూనాలు
namunalu	దావి	నమూనాలు
namuunaalu	దాపి	నమూనాలు
namoonaalo	నమూనాలో	నమూనాలో
namunalo	నమూనాలో	నమూనాలో
namuunaaloo	నమూనాలో	నమూనాలో
nammaru	విచె	నమ్మరు
nammi	నమ్మి	నమ్మి
nammika	నమ్మిక	నమ్మిక
nayam	చె	నయం
nayeem	నయీం	నయీం
naram	రు	నరం
narasimgaraavu	నరసింగరావు	నరసింగరావు
narasingaraavu	జువినో	నరసింగరావు
narasingarao	నరసింగరావు	నరసింగరావు
nala	నల	నల
naludu	రు	నలుడు
nalumulala	నోజు	నలుమూలలా
nalumuulalaa	జుజు	నలుమూలలా
nalgonda	విరు	నల్గొండ
nallapareddi	విరులే	నల్లపరెడ్డి
nallapareddy	లేదాతో	నల్లపరెడ్డి
nallaparedii	దానోజు	నల్లపరెడ్డి
navambaru	జువి	నవంబరు
nevemberu	నవంబరు	నవంబరు
navambarloo	నవంబరులో	నవంబరులో
navambarulo	నవంబరులో	నవంబరులో
navambaruloe	జురు	నవంబరులో
novemberloo	పినో	నవంబరులో
navaneeth	దాదా	నవనీత్
navaniit	జురు	నవనీత్
navanit	పివి	నవనీత్
navarasa	నవరస	నవరస
navi	చె	నవి
naveen	నవీన్	నవీన్
naviin	జు	నవీన్
navin	జు	నవీన్
naatadam	పి	నాటడం
naate	నాటే	నాటే
naatee	నాటే	నాటే
naateenduku	తోనోవి	నాటేందుకు
naatemduku	నోదానో	నాటేందుకు
naatendhuku	చెజుతో	నాటేందుకు
naader	నాదిర్	నాదిర్
naadhir	కాలే	నాదిర్
naadir	పిరు	నాదిర్
nadir	చెలే	నాదిర్
naana	నాన	నాన
naanudi	విదా	నానుడి
naayaku	నో	నాయకు
nayaku	రు	నాయకు
naayakudi	నాయకుడి	నాయకుడి
nayakudi	పిదా	నాయకుడి
naayakudini	నాయకుడిని	నాయకుడిని
nayakudini	నాయకుడిని	నాయకుడిని
naayakulugaa	నాయకులుగా	నాయకులుగా
naaloe	నాలో	నాలో
naaloo	పి	నాలో
nalo	నాలో	నాలో
naasthika	చెచె	నాస్తిక
naastika	నాస్తిక	నాస్తిక
naasthikudu	పివివి	నాస్తికుడు
naastikudu	తోకాలే	నాస్తికుడు
nikshiptam	రుదారు	నిక్షిప్తం
nikshiptham	రుకావి	నిక్షిప్తం
nicchena	చెకా	నిచ్చెన
nichchena	నిచ్చెన	నిచ్చెన
nichhena	పిలే	నిచ్చెన
nijaayathee	కాతో	నిజాయతీ
nijaayathi	నిజాయతీ	నిజాయతీ
nidamarru	చెదా	నిడమర్రు
nidivi	నోపి	నిడివి
nipunhudu	కాదా	నిపుణుడు
nipunudu	రువి	నిపుణుడు
nibandhanalanu	నోచెచె	నిబంధనలను
nimishamlo	జుచె	నిమిషంలో
nimishamloo	నిమిషంలో	నిమిషంలో
nimishaaniki	నిమిషానికి	నిమిషానికి
nimishaniki	నిమిషానికి	నిమిషానికి
nimishaallo	నిమిషాల్లో	నిమిషాల్లో
nimishaalloo	నిమిషాల్లో	నిమిషాల్లో
nimishallo	తోతోతో	నిమిషాల్లో
nimushaala	నిముషాల	నిముషాల
nimushala	దాచె	నిముషాల
nimushaalaku	నిముషాలకు	నిముషాలకు
nimushalaku	కారువి	నిముషాలకు
nirasanagaa	నిరసనగా	నిరసనగా
nirodakata	పినో	నిరోధకత
nirodhakata	నిరోధకత	నిరోధకత
niroodhakata	నిరోధకత	నిరోధకత
niroodhakatam	నోనో	నిరోధకత
nirodhinchadamlo	నిరోధించడంలో	నిరోధించడంలో
niroodhinchadamloo	నిరోధించడంలో	నిరోధించడంలో
nirodhinchadaaniki	నిరోధించడానికి	నిరోధించడానికి
niroodhinchadaaniki	నిరోధించడానికి	నిరోధించడానికి
nirdhinchenduku	దాతోవితో	నిరోధించేందుకు
niroodhinchenduku	నిరోధించేందుకు	నిరోధించేందుకు
nirdhaarinchadam	పిజుచెజు	నిర్ధారించడం
nirdharinchadam	పితోతోకా	నిర్ధారించడం
nirdaarinchadaaniki	నిర్ధారించడానికి	నిర్ధారించడానికి
nirdhaarinchadaaniki	నిర్ధారించడానికి	నిర్ధారించడానికి
nirdharinchadaniki	కాలేచెనోనో	నిర్ధారించడానికి
nirdhaarinchaadu	నిర్ధారించాడు	నిర్ధారించాడు
nirdharinchadu	నోజురుజు	నిర్ధారించాడు
nirdhaarinchaaru	నిర్ధారించారు	నిర్ధారించారు
nirdharincharu	నిర్ధారించారు	నిర్ధారించారు
nirdhaarinchindi	నిర్ధారించింది	నిర్ధారించింది
nirdharinchindi	దాదావిరు	నిర్ధారించింది
nirdhaarimchae	నిర్ధారించే	నిర్ధారించే
nirdhaarinche	పిదావి	నిర్ధారించే
nirdharinche	జువివి	నిర్ధారించే
nirmimpa	రుచె	నిర్మింప
nirmoolinchaali	నిర్మూలించాలి	నిర్మూలించాలి
nirmulinchali	నిర్మూలించాలి	నిర్మూలించాలి
nirmoolinchi	జుపిపి	నిర్మూలించి
nirmulinchi	నిర్మూలించి	నిర్మూలించి
nirmuulinchi	నోజుతో	నిర్మూలించి
nirvachimchadam	తోరులే	నిర్వచించడం
nirvachinchadam	రురువి	నిర్వచించడం
nirvahinchadam	పిలేపి	నిర్వచించడం
nirvachimchina	జుచెలే	నిర్వచించిన
nirvachinchina	నిర్వచించిన	నిర్వచించిన
nirvachimchae	నిర్వచించే	నిర్వచించే
nirvachinche	నిర్వచించే	నిర్వచించే
nirvaahakudu	నిర్వాహకుడు	నిర్వాహకుడు
nirvahakudu	రుపిపి	నిర్వాహకుడు
nilichina	నిలిచినా	నిలిచినా
nilichinaa	నిలిచినా	నిలిచినా
nivasinche	విలే	నివశించే
nivarinchadaniki	తోచెజువి	నివారించడానికి
nivaasamaina	విచె	నివాసమైన
nivasamaina	నివాసమైన	నివాసమైన
nivaasaaniki	నివాసానికి	నివాసానికి
nivasaniki	నివాసానికి	నివాసానికి
nivaasaanni	పిజునో	నివాసాన్ని
nivasanni	నివాసాన్ని	నివాసాన్ని
nivaasaalu	రుపి	నివాసాలు
nivasalu	తోతో	నివాసాలు
nivaasi	నివాసి	నివాసి
nivasi	నివాసి	నివాసి
nischita	చెదా	నిశ్చిత
nishedhinchadam	రురువి	నిషేధించడం
nishedhibchadu	పిరువి	నిషేధించాడు
nishedhinchaadu	నిషేధించాడు	నిషేధించాడు
nishedhinchaaru	విజువి	నిషేధించారు
nishedhincharu	నిషేధించారు	నిషేధించారు
nishedhinchi	తోకాతో	నిషేధించి
nishedhinchindi	కాపిపి	నిషేధించి
nishedhinche	పినోరు	నిషేధించే
nishtatho	నిష్టతో	నిష్టతో
nishtathoo	రుచె	నిష్టతో
nishtato	పిపి	నిష్టతో
neekorika	నీకోరిక	నీకోరిక
nikorika	నీకోరిక	నీకోరిక
neeta	నీట	నీట
nita	నీట	నీట
neethi	జు	నీతి
neeti	కా	నీతి
neeluni	జుతో	నీలుని
niiluni	తోతో	నీలుని
neevunu	నీవును	నీవును
nunchuni	లేరు	నుంచుని
nundi	నుండి	నుండి
nundina	నుండిన	నుండిన
nudhuti	తోపి	నుదిటి
nudita	నుదిటి	నుదిటి
nuditi	దాతో	నుదిటి
nudhutipai	నుదిటిపై	నుదిటిపై
nuditipai	నుదిటిపై	నుదిటిపై
nuditipie	కావి	నుదిటిపై
noojiveedu	నూజివీడు	నూజివీడు
nujiveedu	లేతో	నూజివీడు
nuujiveedu	పిపి	నూజివీడు
nuziveedu	నూజివీడు	నూజివీడు
nuzividu	తోతో	నూజివీడు
nuziviidu	నూజివీడు	నూజివీడు
nootanamgaa	లేలే	నూతనంగా
noothanamga	నూతనంగా	నూతనంగా
nuthanamga	కాకా	నూతనంగా
nuuthanamgaa	రుచె	నూతనంగా
nootan	దా	నూతన్
noothan	కా	నూతన్
nuthan	చె	నూతన్
nuuthan	రు	నూతన్
noothilo	విరు	నూతిలో
noothiloo	నూతిలో	నూతిలో
nootilo	లేచె	నూతిలో
nuthilo	కాపి	నూతిలో
nruthyaaniki	రుకాతో	నృత్యానికి
nrutyaaniki	జుతోకా	నృత్యానికి
nruthyaanni	చెతోకా	నృత్యాన్ని
nrutyaanni	నృత్యాన్ని	నృత్యాన్ని
negative	చెవి	నెగటివ్
negetive	విజు	నెగటివ్
nigative	తోనో	నెగటివ్
nelakonna	కాతో	నెలకొన్న
naenamtae	నేనంటే	నేనంటే
neenantee	దాపి	నేనంటే
neenai	దా	నేనై
nenai	నేనై	నేనై
neerangaa	నేరంగా	నేరంగా
neramga	నేరంగా	నేరంగా
neramgaa	నేరంగా	నేరంగా
neerasthulaku	రుజునో	నేరస్థులకు
nerasthulaku	వివిచె	నేరస్థులకు
neerasthulanu	నేరస్థులను	నేరస్థులను
nerasthulanu	నేరస్థులను	నేరస్థులను
nersthulanu	లేలేలే	నేరస్థులను
neeraroopanalu	నేరారోపణలు	నేరారోపణలు
neraaroopanalu	కావివి	నేరారోపణలు
neraaropanalu	నేరారోపణలు	నేరారోపణలు
neereedu	పిపి	నేరేడు
neredu	దాలే	నేరేడు
naelapaina	నేలపైన	నేలపైన
neelapaina	పిలే	నేలపైన
nailaan	తోనో	నైలాన్
nylon	దాచె	నైలాన్
noota	తో	నోట
nota	పి	నోట
noble	తోజు	నోబుల్
nobul	నోబుల్	నోబుల్
noobul	నోబుల్	నోబుల్
nowble	నోబుల్	నోబుల్
nomu	నోము	నోము
noomu	నోము	నోము
naukaayaana	నౌకాయాన	నౌకాయాన
noukaayaana	నౌకాయాన	నౌకాయాన
nowkaayaana	నౌకాయాన	నౌకాయాన
panchakamu	కాకా	పంచకము
punchakamu	చెచె	పంచకము
panchatanthra	పిజు	పంచతంత్ర
panchatantra	చెతో	పంచతంత్ర
panchathanthra	పంచతంత్ర	పంచతంత్ర
panchatanthram	జునోపి	పంచతంత్రం
panchatantram	జుచెకా	పంచతంత్రం
panchathanthram	విచెకా	పంచతంత్రం
panchaaraama	దాచె	పంచారామ
pancharaama	విరు	పంచారామ
panchaaraamaalu	పంచారామాలు	పంచారామాలు
panjaab	తోదా	పంజాబ్
panjab	పంజాబ్	పంజాబ్
punjab	పంజాబ్	పంజాబ్
punzab	జుకా	పంజాబ్
pandaka	పండక	పండక
pandagaa	పండగా	పండగా
pakkuna	తోతో	పక్కున
pakshaaniki	కానోకా	పక్షానికి
pakshaniki	దాకాలే	పక్షానికి
pakshaala	వినో	పక్షాల
pakshala	జుతో	పక్షాల
pagadaalu	లేనో	పగడాలు
pacchiga	పచ్చిగా	పచ్చిగా
pachchigaa	పచ్చిగా	పచ్చిగా
pacchigane	దాజువి	పచ్చిగానే
pachchigaane	చెచెచె	పచ్చిగానే
pachigaanee	పిచెతో	పచ్చిగానే
patishtanga	రుతోతో	పటిష్ఠంగా
patishthamgaa	చెవిలే	పటిష్ఠంగా
patishthingaa	పటిష్ఠంగా	పటిష్ఠంగా
patishtamina	పటిష్ఠమైన	పటిష్ఠమైన
patishthamaina	పటిష్ఠమైన	పటిష్ఠమైన
pattana	పట్టణ	పట్టణ
pattanha	జు	పట్టణ
pattanaaniki	నోకారు	పట్టణానికి
pattanhaaniki	జుతోవి	పట్టణానికి
pattanaabhivruddhi	చెకాతోరు	పట్టణాభివృద్ధి
pattanhaabhivruddhi	పట్టణాభివృద్ధి	పట్టణాభివృద్ధి
pattina	పిలే	పట్టిన
pattinadi	తోపి	పట్టినది
padakundaa	పిరు	పడకుండా
padadhu	పడదు	పడదు
padadu	పడదు	పడదు
padalaedu	పడలేదు	పడలేదు
padaledu	పడలేదు	పడలేదు
padaleedhu	రురు	పడలేదు
padavalasina	పడవలసిన	పడవలసిన
patakaalanu	వికా	పతకాలను
pathakaalanu	పతకాలను	పతకాలను
patakaalu	జుపి	పతకాలు
pathakaalu	పతకాలు	పతకాలు
patayae	పతయే	పతయే
pataye	నో	పతయే
pathayee	పి	పతయే
pathra	పత్ర	పత్ర
patra	పత్ర	పత్ర
pathrikalaku	చెతోరు	పత్రికలకు
patrikalaku	పత్రికలకు	పత్రికలకు
pathrikalathoo	జుతోజు	పత్రికలతో
patrikalathoo	తోదాపి	పత్రికలతో
patrikalatoe	దావిరు	పత్రికలతో
pathrikalanu	నోజుకా	పత్రికలను
patrikalanu	పత్రికలను	పత్రికలను
pathrikalaloonuu	దాదాపి	పత్రికలలోనూ
patrikalaloenuu	చెచెజు	పత్రికలలోనూ
patrikalaloonoo	పత్రికలలోనూ	పత్రికలలోనూ
patrikalaloonuu	పత్రికలలోనూ	పత్రికలలోనూ
pathrikaloo	పత్రికలూ	పత్రికలూ
patrikaloo	జువి	పత్రికలూ
patrikaluu	నోపి	పత్రికలూ
padaamuudava	కాపి	పదమూడవ
padamuudava	తోకా	పదమూడవ
padhamoodava	పదమూడవ	పదమూడవ
padhilangaa	పదిలంగా	పదిలంగా
padilangaa	నోచె	పదిలంగా
padmanaabham	పద్మనాభం	పద్మనాభం
padmanabham	కాతో	పద్మనాభం
padhyam	లే	పద్యం
padyam	పద్యం	పద్యం
panitanam	రులే	పనితనం
panithanam	జురు	పనితనం
pannaagam	పన్నాగం	పన్నాగం
pannagum	వివి	పన్నాగం
pannu	పన్ను	పన్ను
parachaaru	పరచారు	పరచారు
parachaalani	జునో	పరచాలని
parachi	దా	పరచి
parachimdi	చెపి	పరచింది
parachindi	తోనో	పరచింది
parabhaasha	పరభాష	పరభాష
parabhasha	రు	పరభాష
paramapadamu	చెజు	పరమపదము
paramapadinchaaru	పరమపదించారు	పరమపదించారు
paramapadincharu	దావిపి	పరమపదించారు
paramaathmanu	పరమాత్మను	పరమాత్మను
paramaatmanu	రులేలే	పరమాత్మను
paramaatmanae	రులేవి	పరమాత్మనే
paramaatmane	విదారు	పరమాత్మనే
paramaatmanee	పరమాత్మనే	పరమాత్మనే
paramaatmaa	పరమాత్మా	పరమాత్మా
paramaatmuni	విపిరు	పరమాత్ముని
parikaramu	లేకా	పరికరము
parikaramulu	పరికరములు	పరికరములు
parikaraaniki	రుతోదా	పరికరానికి
parikaraanni	జుచెవి	పరికరాన్ని
parinaamaaniki	కాలేకా	పరిణామానికి
parinhaamaaniki	నోపిదా	పరిణామానికి
parinaamaanni	కాచెచె	పరిణామాన్ని
parinhaamaanni	లేలేవి	పరిణామాన్ని
parinaamaalu	చెరులే	పరిణామాలు
parinhaamaalu	పిరుపి	పరిణామాలు
paripaalakulu	దారురు	పరిపాలకులు
paripalakulu	పరిపాలకులు	పరిపాలకులు
paribhramanam	పరిభ్రమణం	పరిభ్రమణం
parirakshimchae	నోదాచె	పరిరక్షించే
parirakshinchae	పరిరక్షించే	పరిరక్షించే
parirakshinchee	పరిరక్షించే	పరిరక్షించే
parishuddamaina	చెరుపి	పరిశుద్ధమైన
parisuddhamaina	పరిశుద్ధమైన	పరిశుద్ధమైన
prishuddhamaina	పరిశుద్ధమైన	పరిశుద్ధమైన
parisramala	పరిశ్రమల	పరిశ్రమల
parisramalalo	రుచెచె	పరిశ్రమలలో
parisramalaloe	పికాచె	పరిశ్రమలలో
paruchoori	పరుచూరి	పరుచూరి
paruchuri	చెచె	పరుచూరి
paruchuuri	నోదా	పరుచూరి
paryavasaanam	పర్యవసానం	పర్యవసానం
paryavasanam	పర్యవసానం	పర్యవసానం
paryavasaanaalanu	పర్యవసానాలను	పర్యవసానాలను
paryavasanalanu	పర్యవసానాలను	పర్యవసానాలను
parvam	పర్వం	పర్వం
palakadam	కా	పలకడం
palakadaaniki	పలకడానికి	పలకడానికి
palakanu	పలకను	పలకను
palakalanu	పలకలను	పలకలను
palaka	వి	పలకా
palakaa	పలకా	పలకా
palachaga	పి	పలచగా
palachagaa	పలచగా	పలచగా
palachani	పలచని	పలచని
palukulanu	కాకా	పలుకులను
pallakilo	వికా	పల్లకిలో
pallakiloe	లేలే	పల్లకిలో
pallakiloo	పల్లకిలో	పల్లకిలో
pallakee	పల్లకీ	పల్లకీ
pallaki	లేదా	పల్లకీ
pallakii	పల్లకీ	పల్లకీ
pasaru	చె	పసరు
pasitanam	వికా	పసితనం
pasithanam	తోవి	పసితనం
paamditya	కాకా	పాండిత్య
paandithya	పితో	పాండిత్య
paamdityam	నోరుచె	పాండిత్యం
paandithyam	పాండిత్యం	పాండిత్యం
paandithyaanni	చెదాదాదా	పాండిత్యాన్ని
pamdityaanni	పిరుపివి	పాండిత్యాన్ని
paamdu	పాండు	పాండు
paandu	పాండు	పాండు
paakisdhaan	పివిలే	పాకిస్థాన్
paakisthaan	పాకిస్థాన్	పాకిస్థాన్
pakistan	పాకిస్థాన్	పాకిస్థాన్
pakisthan	చెతోవి	పాకిస్థాన్
paakshika	పాక్షిక	పాక్షిక
pakshika	లేజు	పాక్షిక
paajitiv	జురు	పాజిటివ్
pasitiv	పాజిటివ్	పాజిటివ్
positiv	జులే	పాజిటివ్
positive	తోవి	పాజిటివ్
paatar	కా	పాటర్
patar	రు	పాటర్
pattar	చె	పాటర్
patter	పాటర్	పాటర్
potar	లే	పాటర్
pottaar	లే	పాటర్
pottar	వి	పాటర్
potter	పాటర్	పాటర్
paatnaa	పికా	పాట్నా
patna	పాట్నా	పాట్నా
paadina	రు	పాడిన
padina	తో	పాడిన
paadukune	పాడుకునే	పాడుకునే
padukune	పినో	పాడుకునే
paatavi	జు	పాతవి
paathavi	చె	పాతవి
patavi	జు	పాతవి
paara	జు	పార
para	పార	పార
paaramparya	నోవి	పారంపర్య
paaraayana	జుజు	పారాయణ
paaraayanha	లేచె	పారాయణ
paaraayanam	పిచె	పారాయణం
paaraayanham	దాపి	పారాయణం
paaraayanamu	పారాయణము	పారాయణము
paaraayanhamu	పిలే	పారాయణము
paarindhi	తోజు	పారింది
paarindi	పారింది	పారింది
paarudala	పినో	పారుదల
paartanars	పార్టనర్స్	పార్టనర్స్
paartanrs	నోవిపి	పార్టనర్స్
paartnars	జురుదా	పార్టనర్స్
paartners	లేచెచె	పార్టనర్స్
partnars	తోతోరు	పార్టనర్స్
partners	జువిచె	పార్టనర్స్
paalapunta	వికా	పాలపుంత
paalapuntha	పాలపుంత	పాలపుంత
palapunta	దానో	పాలపుంత
palapuntha	పాలపుంత	పాలపుంత
paauline	పాలిన్	పాలిన్
paulin	విదా	పాలిన్
pauline	రుకా	పాలిన్
paalpadatam	పాల్పడటం	పాల్పడటం
palpadatam	పాల్పడటం	పాల్పడటం
paalpadindhi	పాల్పడింది	పాల్పడింది
paalpadindi	కారురు	పాల్పడింది
palpadindi	దాజుకా	పాల్పడింది
paasaina	తో	పాసైన
pasaina	దా	పాసైన
paasta	తోవి	పాస్తా
paastaa	నోకా	పాస్తా
paastha	పాస్తా	పాస్తా
pasta	రుకా	పాస్తా
pastha	పిదా	పాస్తా
pindaaniki	లేనోకా	పిండానికి
pindaniki	నోదానో	పిండానికి
picca	పి	పిక్క
pikka	తో	పిక్క
pitamaha	దానో	పితామహ
pithaamaha	తోవి	పితామహ
pithamaha	విదా	పితామహ
pithasaya	పిత్తాశయ	పిత్తాశయ
pittaasaya	పిత్తాశయ	పిత్తాశయ
pittasaya	పిత్తాశయ	పిత్తాశయ
pinni	పిన్ని	పిన్ని
piramid	పిరమిడ్	పిరమిడ్
pyramid	చెకా	పిరమిడ్
pillanagroovi	పిల్లనగ్రోవి	పిల్లనగ్రోవి
pillangrovi	జుపిజుచె	పిల్లనగ్రోవి
pilar	చెరు	పిల్లర్
pillar	జురు	పిల్లర్
piller	చెజు	పిల్లర్
peal	పీల్	పీల్
peel	పీల్	పీల్
piil	రు	పీల్
pundu	జు	పుండు
puntalu	పినో	పుంతలు
punthalu	దాలే	పుంతలు
putte	కావి	పుట్టే
puttee	చెపి	పుట్టే
punaraavaasa	పునరావాస	పునరావాస
punaravasa	పునరావాస	పునరావాస
punaraavaasam	చెలేవి	పునరావాసం
punaravasam	జుకాపి	పునరావాసం
punariddharinchadam	పునరుద్ధరించడం	పునరుద్ధరించడం
punaruddarinchadam	పునరుద్ధరించడం	పునరుద్ధరించడం
punaruddharinchadam	పునరుద్ధరించడం	పునరుద్ధరించడం
punaruddharinchadaaniki	రువికాదారురు	పునరుద్ధరించడానికి
punaruddarinchaaru	పునరుద్ధరించారు	పునరుద్ధరించారు
punaruddharinchaaru	పునరుద్ధరించారు	పునరుద్ధరించారు
punaruddharinchi	జుతోరునో	పునరుద్ధరించి
punaruddharinche	విరుకాలే	పునరుద్ధరించే
punaruddharinchee	పునరుద్ధరించే	పునరుద్ధరించే
punarnirmaana	జులేచెవి	పునర్నిర్మాణ
punarnirmaanha	నోచెచెపి	పునర్నిర్మాణ
punarnirmaanam	పినోకానో	పునర్నిర్మాణం
punarnirmaanham	పిలేపిలే	పునర్నిర్మాణం
punarnirmaanaaniki	దాలేపిజులే	పునర్నిర్మాణానికి
punarnirmaanhaaniki	పునర్నిర్మాణానికి	పునర్నిర్మాణానికి
purapaalaka	కాపి	పురపాలక
purapalaka	పురపాలక	పురపాలక
puraanamu	పురాణము	పురాణము
puraanhamu	పురాణము	పురాణము
puraanamulanu	పురాణములను	పురాణములను
puraanhamulanu	కాజునో	పురాణములను
puraanamulatho	జుపికా	పురాణములలో
puraanamulato	పురాణములలో	పురాణములలో
puraanhamulaloo	పురాణములలో	పురాణములలో
puraanamulo	నోనోతో	పురాణములో
puraanhamuloo	పురాణములో	పురాణములో
puraatanamaina	పురాతనమైన	పురాతనమైన
puraathanamaina	పురాతనమైన	పురాతనమైన
puratanamaina	దాదాదా	పురాతనమైన
purathanamaina	పురాతనమైన	పురాతనమైన
puvvula	నోకా	పువ్వుల
puvvulatho	పువ్వులతో	పువ్వులతో
puvvulathoo	పువ్వులతో	పువ్వులతో
puvvulato	పువ్వులతో	పువ్వులతో
puvvulanu	దారునో	పువ్వులను
puvvulalo	పిలేచె	పువ్వులలో
puvvulaloo	చెజుపి	పువ్వులలో
pushya	కా	పుష్య
poojagaa	తో	పూజగా
poojalanu	లేతో	పూజలను
poojalalo	పూజలలో	పూజలలో
poojalaloo	దాతో	పూజలలో
poojimchadam	పూజించడం	పూజించడం
poojinchadam	పూజించడం	పూజించడం
puujinchadam	తోలే	పూజించడం
poojimchina	చెపి	పూజించిన
poojinchina	పూజించిన	పూజించిన
puujinchina	రుజు	పూజించిన
poojimpa	చెపి	పూజింప
poojinpa	పూజింప	పూజింప
puujimpa	పూజింప	పూజింప
poodika	పి	పూడిక
pudika	కా	పూడిక
puudika	వి	పూడిక
poorita	చె	పూరిత
pooritha	లే	పూరిత
pooritamaina	దావి	పూరితమైన
poorithamaina	పూరితమైన	పూరితమైన
purithamaina	జుకా	పూరితమైన
poosi	తో	పూసి
puusi	పూసి	పూసి
prudhu	పృథు	పృథు
pruthu	నో	పృథు
pemdalam	కాతో	పెండలం
pendalam	పెండలం	పెండలం
pempudu	పెంపుడు	పెంపుడు
penpudu	పెంపుడు	పెంపుడు
pekku	కాదా	పెక్కు
pettelo	పెట్టెలో	పెట్టెలో
petteloe	పిచె	పెట్టెలో
petteloo	కానో	పెట్టెలో
petrol	పెట్రోల్	పెట్రోల్
pedataadu	పిలే	పెడతాడు
pedathaadu	తోలే	పెడతాడు
peduthundagaa	పెడుతుండగా	పెడుతుండగా
pedutundagaa	పిచెచె	పెడుతుండగా
penampai	చెలే	పెనంపై
penampie	నోతో	పెనంపై
penamlo	పెనంలో	పెనంలో
penamloe	పెనంలో	పెనంలో
penamloo	పెనంలో	పెనంలో
pennii	కాచె	పెన్నీ
penny	నోకా	పెన్నీ
pennulu	పెన్నులు	పెన్నులు
pepshi	పెప్సీ	పెప్సీ
pepsi	పెప్సీ	పెప్సీ
pepsii	జునో	పెప్సీ
perigi	పెరిగి	పెరిగి
perugudala	పెరుగుదల	పెరుగుదల
perugudhala	జురు	పెరుగుదల
perugudalato	జుపిజు	పెరుగుదలతో
perugudalatoe	రుపిరు	పెరుగుదలతో
perugudhalathoo	పెరుగుదలతో	పెరుగుదలతో
perugudalanu	తోరులే	పెరుగుదలను
perugudhalanu	రుతోలే	పెరుగుదలను
paeda	వి	పేడ
peda	చె	పేడ
paerantaalu	చెతో	పేరంటాలు
peramtaalu	పిచె	పేరంటాలు
perantaalu	నోచె	పేరంటాలు
paerennika	పేరెన్నిక	పేరెన్నిక
perennika	వితోలే	పేరెన్నిక
paerlaku	పేర్లకు	పేర్లకు
perlaku	పేర్లకు	పేర్లకు
paerlathoo	పేర్లతో	పేర్లతో
paerlato	పేర్లతో	పేర్లతో
perlatho	జుజు	పేర్లతో
perlato	జుజు	పేర్లతో
paerlanu	పివి	పేర్లను
perlanu	పేర్లను	పేర్లను
paerlalo	పిజు	పేర్లలో
paerlaloo	విలే	పేర్లలో
perlalo	కాలే	పేర్లలో
paain	తో	పైన్
pain	పి	పైన్
pine	పైన్	పైన్
paipulu	పైపులు	పైపులు
paibhaagaanni	రునోలే	పైభాగాన్ని
pomdaali	దాపి	పొందాలి
pondaali	పొందాలి	పొందాలి
pondhaali	పొందాలి	పొందాలి
pomdinattu	పొందినట్టు	పొందినట్టు
pondhinattu	పొందినట్టు	పొందినట్టు
pondinattu	నోకావి	పొందినట్టు
pomdinavi	విపి	పొందినవి
pondinavi	పొందినవి	పొందినవి
pomdutaam	నోనో	పొందుతాం
pondutaam	జుకా	పొందుతాం
pondutam	దాకా	పొందుతాం
pmdutunna	నోచెపి	పొందుతున్న
pondutunna	కాదాదా	పొందుతున్న
pondae	పొందే	పొందే
ponde	రు	పొందే
pondhee	వి	పొందే
pondaevaaru	దావిలే	పొందేవారు
pondevaaru	నోదాకా	పొందేవారు
pondheevaaru	జులేపి	పొందేవారు
potta	పొట్ట	పొట్ట
pottakooti	నోనోజు	పొట్టకూటి
pottakuuti	పొట్టకూటి	పొట్టకూటి
pottatho	విచె	పొట్టతో
pottathoo	పొట్టతో	పొట్టతో
pottato	పొట్టతో	పొట్టతో
pottapai	రుచె	పొట్టపై
pottalo	వికా	పొట్టలో
pottaloo	చెతో	పొట్టలో
podachoopaayi	లేదాజు	పొడచూపాయి
podachupayi	పొడచూపాయి	పొడచూపాయి
pogadachoopaayi	పొడచూపాయి	పొడచూపాయి
podhupugaa	జుజు	పొదుపుగా
podupugaa	లేజు	పొదుపుగా
podhupunu	పొదుపును	పొదుపును
podupunu	పొదుపును	పొదుపును
polam	రు	పొలం
polamlo	పొలంలో	పొలంలో
polamloe	పొలంలో	పొలంలో
polamloo	పొలంలో	పొలంలో
polaala	పి	పొలాల
polaalaku	విలే	పొలాలకు
podu	పోడు	పోడు
poedu	జు	పోడు
poodu	పోడు	పోడు
potunnadi	వివిదా	పోతున్నది
poortunnaaru	కాతోపి	పోతున్నారు
potunnaaru	లేజుపి	పోతున్నారు
poenichchadu	పికాపి	పోనిచ్చాడు
ponichchaadu	నోరుపి	పోనిచ్చాడు
poonicchaadu	పోనిచ్చాడు	పోనిచ్చాడు
pooyaaraa	పోయారా	పోయారా
poyaaraa	రుతో	పోయారా
poyara	కాదా	పోయారా
pole	దా	పోలే
poolee	పోలే	పోలే
pol	లే	పోల్
pole	పోల్	పోల్
poll	దా	పోల్
poeshimchaaru	పోషించారు	పోషించారు
pooshinchaaru	పోషించారు	పోషించారు
poeshimchinadi	వినోనో	పోషించినది
pooshinchinadi	పోషించినది	పోషించినది
poeshimchae	పోషించే	పోషించే
pooshinche	పోషించే	పోషించే
pooshinchee	చెలే	పోషించే
poostarlu	నోరుజు	పోస్టర్లు
postarlu	పోస్టర్లు	పోస్టర్లు
posterlu	పోస్టర్లు	పోస్టర్లు
prakatanalaku	ప్రకటనలకు	ప్రకటనలకు
prakatanalanu	లేపిపి	ప్రకటనలను
prakash	ప్రకాష్	ప్రకాష్
prajaadaranha	పిజు	ప్రజాదరణ
prajaadharana	ప్రజాదరణ	ప్రజాదరణ
prataapa	కావి	ప్రతాప
prathaapa	చెరు	ప్రతాప
prataapam	ప్రతాపం	ప్రతాపం
prathaapam	కారు	ప్రతాపం
prataaparudra	ప్రతాపరుద్ర	ప్రతాపరుద్ర
prataparudra	ప్రతాపరుద్ర	ప్రతాపరుద్ర
prathaaparudhra	ప్రతాపరుద్ర	ప్రతాపరుద్ర
prataaparudrudu	ప్రతాపరుద్రుడు	ప్రతాపరుద్రుడు
prathaaparudhrudu	నోనోపిరు	ప్రతాపరుద్రుడు
prataaparudruni	వినోవిపి	ప్రతాపరుద్రుని
prathaaparudhruni	ప్రతాపరుద్రుని	ప్రతాపరుద్రుని
prathinidhulanu	ప్రతినిధులను	ప్రతినిధులను
pratinidhulanu	లేదాదావి	ప్రతినిధులను
prathinidhulu	కాపిపి	ప్రతినిధులు
pratinidhulu	నోపిచె	ప్రతినిధులు
prathifalam	లేజు	ప్రతిఫలం
prathiphalam	ప్రతిఫలం	ప్రతిఫలం
prathifalangaa	రుతోపి	ప్రతిఫలంగా
prathiphamgaa	రులేనో	ప్రతిఫలంగా
pratiphalamgaa	జువినో	ప్రతిఫలంగా
prathifalaanni	పిపినోరు	ప్రతిఫలాన్ని
prathiphalaanni	చెనోపివి	ప్రతిఫలాన్ని
pratiphalaanni	ప్రతిఫలాన్ని	ప్రతిఫలాన్ని
prathibimba	ప్రతిబింబ	ప్రతిబింబ
prathibinba	ప్రతిబింబ	ప్రతిబింబ
pratibimba	తోపిరు	ప్రతిబింబ
prathibimbam	రుదావి	ప్రతిబింబం
pratibimbam	నోదావి	ప్రతిబింబం
prathibimbaanni	నోజుజురు	ప్రతిబింబాన్ని
pratibimbaanni	విజుతోలే	ప్రతిబింబాన్ని
prathibimbinchee	ప్రతిబింబించే	ప్రతిబింబించే
pratibimbimchae	జుకాపిరు	ప్రతిబింబించే
pratibimbincee	రుచెజుజు	ప్రతిబింబించే
pratibimbistuu	ప్రతిబింబిస్తూ	ప్రతిబింబిస్తూ
pradeep	చెతో	ప్రదీప్
pradiip	కాపి	ప్రదీప్
pradaesamae	ప్రదేశమే	ప్రదేశమే
pradeshame	జువి	ప్రదేశమే
pradheeshamee	ప్రదేశమే	ప్రదేశమే
pradhaanamgaa	ప్రధానంగా	ప్రధానంగా
pradhananga	కాచెరు	ప్రధానంగా
pradhaanamaina	ప్రధానమైన	ప్రధానమైన
pradhaanamiena	కాదాతో	ప్రధానమైన
pradhanamyna	ప్రధానమైన	ప్రధానమైన
praddhaanopaadhyayudu	నోచెకారుచె	ప్రధానోపాధ్యాయుడు
pradhaanopaadhyaayudu	లేకాచెలేజు	ప్రధానోపాధ్యాయుడు
pradhanoopaadhyaayudu	పిలేరులేవి	ప్రధానోపాధ్యాయుడు
pradhaan	ప్రధాన్	ప్రధాన్
prabho	ప్రభో	ప్రభో
prabhoo	ప్రభో	ప్రభో
pramaanha	నోదా	ప్రమాణ
pramana	ప్రమాణ	ప్రమాణ
pramaanhamgaa	చెపిలే	ప్రమాణంగా
pramanamga	ప్రమాణంగా	ప్రమాణంగా
pramaanhamu	రుతో	ప్రమాణము
pramanamu	ప్రమాణము	ప్రమాణము
pramaanhamulu	ప్రమాణములు	ప్రమాణములు
pramanamulu	నోరుతో	ప్రమాణములు
pramaanhaanni	ప్రమాణాన్ని	ప్రమాణాన్ని
pramananni	జునోవి	ప్రమాణాన్ని
pramaanhaalloe	ప్రమాణాల్లో	ప్రమాణాల్లో
pramaanhaalloo	నోకాపి	ప్రమాణాల్లో
pramanaalloo	జుదాచె	ప్రమాణాల్లో
prameela	ప్రమీల	ప్రమీల
pramiila	నోరు	ప్రమీల
pramukhamainavi	ప్రముఖమైనవి	ప్రముఖమైనవి
pramukhulaku	దాజునో	ప్రముఖులకు
pramukhulatho	ప్రముఖులతో	ప్రముఖులతో
pramukhulato	ప్రముఖులతో	ప్రముఖులతో
pramukhulatoo	ప్రముఖులతో	ప్రముఖులతో
pramukhulanu	పిపివి	ప్రముఖులను
pramukhulalo	ప్రముఖులలో	ప్రముఖులలో
pramukhulaloo	విలేదా	ప్రముఖులలో
pramukhulaina	రుజుకా	ప్రముఖులైన
prayaaninchae	నోదావి	ప్రయాణించే
prayaninchey	కాదాజు	ప్రయాణించే
prayaanhikulanu	లేనోలేవి	ప్రయాణికులను
prayaanikulanu	రులేవినో	ప్రయాణికులను
prayanikulanu	ప్రయాణికులను	ప్రయాణికులను
prayaanhikulu	నోపిరు	ప్రయాణికులు
prayaanikulu	ప్రయాణికులు	ప్రయాణికులు
prayanikulu	ప్రయాణికులు	ప్రయాణికులు
pravrtti	పితోతో	ప్రవృత్తి
pravrutti	ప్రవృత్తి	ప్రవృత్తి
pravvrhutthi	ప్రవృత్తి	ప్రవృత్తి
pravrhutthini	ప్రవృత్తిని	ప్రవృత్తిని
pravrttini	లేపివి	ప్రవృత్తిని
pravruttini	జుతోనో	ప్రవృత్తిని
pravesamu	ప్రవేశము	ప్రవేశము
praveshamu	పితో	ప్రవేశము
praveshinchakunda	ప్రవేశించకుండా	ప్రవేశించకుండా
praveshinchakundaa	నోజుపితో	ప్రవేశించకుండా
pravesinchakunda	కాజురుతో	ప్రవేశించకుండా
praveshinchataaniki	లేలేనోతోచె	ప్రవేశించటానికి
praveshinchataniki	రువివితోరు	ప్రవేశించటానికి
pravesinchataniki	దారురులేనో	ప్రవేశించటానికి
praveshinchadaaniki	ప్రవేశించడానికి	ప్రవేశించడానికి
praveshinchadaniki	నోకాచెలేకా	ప్రవేశించడానికి
pravesinchadaniki	పిలేతోనోలే	ప్రవేశించడానికి
pravaesinchaadu	వివితోకా	ప్రవేశించాడు
praveshinchadu	వితోదాదా	ప్రవేశించాడు
pravesinchadu	పికాచెచె	ప్రవేశించాడు
pravaesinchi	ప్రవేశించి	ప్రవేశించి
praveshinchi	తోరురు	ప్రవేశించి
pravesinchi	ప్రవేశించి	ప్రవేశించి
pravaesinchina	నోరుపి	ప్రవేశించిన
praveshinchina	రుకాపి	ప్రవేశించిన
pravesinchina	ప్రవేశించిన	ప్రవేశించిన
pravaesinchu	ప్రవేశించు	ప్రవేశించు
praveshinchu	కాలేపి	ప్రవేశించు
pravesinchu	ప్రవేశించు	ప్రవేశించు
pravaesinchae	ప్రవేశించే	ప్రవేశించే
praveshinche	ప్రవేశించే	ప్రవేశించే
pravesinche	లేదాలే	ప్రవేశించే
pravaesinchaenduku	కావివిపిచె	ప్రవేశించేందుకు
praveshinchenduku	ప్రవేశించేందుకు	ప్రవేశించేందుకు
pravesinchenduku	ప్రవేశించేందుకు	ప్రవేశించేందుకు
prasaadaraavu	కాచెజు	ప్రసాదరావు
prasadarao	ప్రసాదరావు	ప్రసాదరావు
prasadaravu	కాపికా	ప్రసాదరావు
prasaaraala	ప్రసారాల	ప్రసారాల
prasaaraalaku	నోకాపి	ప్రసారాలకు
prasaaraalu	ప్రసారాలు	ప్రసారాలు
praamthamulo	లేవిజు	ప్రాంతములో
praantamuloo	ప్రాంతములో	ప్రాంతములో
praanthamulo	రునోరు	ప్రాంతములో
praachina	నోతో	ప్రాచీన
praaciina	ప్రాచీన	ప్రాచీన
prachina	జునో	ప్రాచీన
praajektunu	ప్రాజెక్టును	ప్రాజెక్టును
prajektunu	రువిరుజు	ప్రాజెక్టును
projectunu	ప్రాజెక్టును	ప్రాజెక్టును
praajektulatoo	ప్రాజెక్టులతో	ప్రాజెక్టులతో
prajektulato	కాజుదాకా	ప్రాజెక్టులతో
projectlatho	ప్రాజెక్టులతో	ప్రాజెక్టులతో
praajektulu	ప్రాజెక్టులు	ప్రాజెక్టులు
prajektulu	ప్రాజెక్టులు	ప్రాజెక్టులు
projectulu	ప్రాజెక్టులు	ప్రాజెక్టులు
project	ప్రాజెక్ట్	ప్రాజెక్ట్
projekt	పితోనో	ప్రాజెక్ట్
prozect	ప్రాజెక్ట్	ప్రాజెక్ట్
praana	ప్రాణ	ప్రాణ
prana	కా	ప్రాణ
praananga	చెదా	ప్రాణంగా
pranamga	నోతో	ప్రాణంగా
praanamu	తోనో	ప్రాణము
pranamu	ప్రాణము	ప్రాణము
praanamulu	జువిరు	ప్రాణములు
pranamulu	చెచెదా	ప్రాణములు
praaanaanni	వినోకా	ప్రాణాన్ని
pranaanni	పికావి	ప్రాణాన్ని
prananni	దాలేపి	ప్రాణాన్ని
praanaalatho	ప్రాణాలతో	ప్రాణాలతో
praanaalato	ప్రాణాలతో	ప్రాణాలతో
pranalatho	నోరువి	ప్రాణాలతో
praathipadhikagaa	జుచెకాకా	ప్రాతిపదికగా
praatipadikagaa	ప్రాతిపదికగా	ప్రాతిపదికగా
praathipadhikana	ప్రాతిపదికన	ప్రాతిపదికన
praatipadikana	ప్రాతిపదికన	ప్రాతిపదికన
praathipadhikapai	పిచెతోజు	ప్రాతిపదికపై
praatipadikapai	విచెదానో	ప్రాతిపదికపై
praatipadikapie	ప్రాతిపదికపై	ప్రాతిపదికపై
praadhamikamga	ప్రాథమికంగా	ప్రాథమికంగా
praadhamikamgaa	విపిదా	ప్రాథమికంగా
prathamikangaa	ప్రాథమికంగా	ప్రాథమికంగా
praapthiki	కావిచె	ప్రాప్తికి
praaptiki	ప్రాప్తికి	ప్రాప్తికి
praapthini	లేవివి	ప్రాప్తిని
praaptini	లేతోరు	ప్రాప్తిని
praayamaina	ప్రాయమైన	ప్రాయమైన
praayamiena	లేపి	ప్రాయమైన
praayamina	రునో	ప్రాయమైన
prayamaina	చెనో	ప్రాయమైన
preet	వితో	ప్రీత్
preeth	ప్రీత్	ప్రీత్
french	ప్రెంచ్	ప్రెంచ్
prench	తోరు	ప్రెంచ్
praemikulugaa	లేజులేకా	ప్రేమికులుగా
preemikulugaa	లేలేజుజు	ప్రేమికులుగా
premikulugaa	ప్రేమికులుగా	ప్రేమికులుగా
prodakctions	తోనోతోదా	ప్రొడక్షన్స్
prodakshans	పినోకాజు	ప్రొడక్షన్స్
productions	ప్రొడక్షన్స్	ప్రొడక్షన్స్
produkshans	ప్రొడక్షన్స్	ప్రొడక్షన్స్
prodacts	ప్రోడక్ట్స్	ప్రోడక్ట్స్
products	నోపిచె	ప్రోడక్ట్స్
funk	దా	ఫంక్
funq	జు	ఫంక్
phunk	దా	ఫంక్
fangal	ఫంగల్	ఫంగల్
fungal	ఫంగల్	ఫంగల్
fuungal	జు	ఫంగల్
phangal	ఫంగల్	ఫంగల్
phungal	వి	ఫంగల్
falitam	ఫలితం	ఫలితం
falitham	కా	ఫలితం
phalitam	వి	ఫలితం
phalitham	తో	ఫలితం
faaloo	ఫాలో	ఫాలో
follow	ఫాలో	ఫాలో
folow	చె	ఫాలో
phaaloe	రు	ఫాలో
phaaloo	వి	ఫాలో
phaloo	కా	ఫాలో
phollow	తో	ఫాలో
fijiks	పినో	ఫిజిక్స్
fysics	రులే	ఫిజిక్స్
phijiks	ఫిజిక్స్	ఫిజిక్స్
physics	పిచె	ఫిజిక్స్
february	జుపి	ఫిబ్రవరి
phibravari	కావి	ఫిబ్రవరి
phiryaadhulanu	ఫిర్యాదులను	ఫిర్యాదులను
phiryaadulanu	ఫిర్యాదులను	ఫిర్యాదులను
phiryadulanu	రురుకా	ఫిర్యాదులను
fod	ఫుడ్	ఫుడ్
food	లే	ఫుడ్
fud	చె	ఫుడ్
phod	నో	ఫుడ్
phud	నో	ఫుడ్
fedaration	నోరు	ఫెడరేషన్
federation	నోరు	ఫెడరేషన్
federetion	ఫెడరేషన్	ఫెడరేషన్
feedeeration	ఫెడరేషన్	ఫెడరేషన్
phederation	పివి	ఫెడరేషన్
fel	వి	ఫెల్
fell	ఫెల్	ఫెల్
phell	నో	ఫెల్
face	ఫేస్	ఫేస్
fees	చె	ఫేస్
phace	ఫేస్	ఫేస్
phaes	ఫేస్	ఫేస్
phas	తో	ఫేస్
phee	ఫేస్	ఫేస్
fillanu	ఫైళ్లను	ఫైళ్లను
phaillhanu	ఫైళ్లను	ఫైళ్లను
fillu	విదా	ఫైళ్లు
phaillhu	నోపి	ఫైళ్లు
fridai	ఫ్రైడే	ఫ్రైడే
friday	దాలే	ఫ్రైడే
phraiday	తోరు	ఫ్రైడే
phriday	ఫ్రైడే	ఫ్రైడే
fluid	దారు	ఫ్లూయిడ్
fluuid	తోజు	ఫ్లూయిడ్
phluid	ఫ్లూయిడ్	ఫ్లూయిడ్
flait	ఫ్లైట్	ఫ్లైట్
flight	ఫ్లైట్	ఫ్లైట్
phlait	ఫ్లైట్	ఫ్లైట్
phlight	లేలే	ఫ్లైట్
banga	దా	బంగా
bangaa	దా	బంగా
bamdii	బందీ	బందీ
bandee	బందీ	బందీ
bamdiilugaa	దానో	బందీలుగా
bandeelugaa	బందీలుగా	బందీలుగా
bandhinchindi	పిదానో	బంధించింది
bandinchindi	బంధించింది	బంధించింది
bacchan	చెవి	బచ్చన్
bachchan	బచ్చన్	బచ్చన్
batuku	బతుకు	బతుకు
batukae	బతుకే	బతుకే
batuke	చె	బతుకే
bammera	తోలే	బమ్మెర
bayatapadataaniki	నోజుపి	బయటపడటానికి
bayatapadataniki	లేదానో	బయటపడటానికి
bayatapadi	జుకా	బయటపడి
bayatapadindhi	జురుకా	బయటపడింది
bayatapadindi	బయటపడింది	బయటపడింది
balagaala	వి	బలగాల
balagaalaku	బలగాలకు	బలగాలకు
balagaalathoo	బలగాలతో	బలగాలతో
balagaalato	బలగాలతో	బలగాలతో
balagaalatoe	లేజు	బలగాలతో
balagaalanu	బలగాలను	బలగాలను
balaheenatha	దాకా	బలహీనత
balahiinata	బలహీనత	బలహీనత
balahinata	రునో	బలహీనత
balaheenathalanu	బలహీనతలను	బలహీనతలను
balahiinatalanu	బలహీనతలను	బలహీనతలను
balahinatalanu	జునోలే	బలహీనతలను
balaheenathalu	బలహీనతలు	బలహీనతలు
balahiinatalu	బలహీనతలు	బలహీనతలు
balahinatalu	తోతో	బలహీనతలు
baligaa	చె	బలిగా
balini	నో	బలిని
balishtamaina	బలిష్టమైన	బలిష్టమైన
balla	జు	బల్ల
ballapai	దాకా	బల్లపై
ballapie	రుజు	బల్లపై
basa	పి	బస
bahishkarinchadam	బహిష్కరించడం	బహిష్కరించడం
bahishkarinchaalani	కాచెలేచె	బహిష్కరించాలని
bahishkarinchalani	బహిష్కరించాలని	బహిష్కరించాలని
bahishkaristhu	చెజునోదా	బహిష్కరిస్తూ
bahishkaristoo	బహిష్కరిస్తూ	బహిష్కరిస్తూ
bahishkaristu	బహిష్కరిస్తూ	బహిష్కరిస్తూ
bahishkaristuu	దాపిపికా	బహిష్కరిస్తూ
bahubhaashaa	కాతో	బహుభాషా
bahubhasha	జుచె	బహుభాషా
bahurupa	బహురూప	బహురూప
bahuruupa	లేచె	బహురూప
bahuuruupa	బహురూప	బహురూప
baak	లే	బాక్
bak	పి	బాక్
bock	చె	బాక్
bocq	బాక్	బాక్
bokk	బాక్	బాక్
baaksaapheesu	చెదాకా	బాక్సాఫీసు
baaksaaphisu	బాక్సాఫీసు	బాక్సాఫీసు
boxoffice	బాక్సాఫీసు	బాక్సాఫీసు
baksing	తోజులే	బాక్సింగ్
boksing	బాక్సింగ్	బాక్సింగ్
boxing	లేదానో	బాక్సింగ్
baagamati	చెచె	బాగమతి
bagamathi	బాగమతి	బాగమతి
baagugaa	విదా	బాగుగా
baguga	బాగుగా	బాగుగా
bagugaa	జుచె	బాగుగా
baagunnaaraa	బాగున్నారా	బాగున్నారా
bagunnara	బాగున్నారా	బాగున్నారా
baajee	పి	బాజీ
baaji	చె	బాజీ
baadhyatalanu	తోరులే	బాధ్యతలను
baadhyathalanu	బాధ్యతలను	బాధ్యతలను
badhyatlanu	తోరుకా	బాధ్యతలను
baapooji	బాపూజీ	బాపూజీ
baapuujii	బాపూజీ	బాపూజీ
bapuji	దాకా	బాపూజీ
baavaa	కా	బావా
bava	దా	బావా
baasatagaa	తోలే	బాసటగా
basataga	బాసటగా	బాసటగా
baahaatamgaa	బాహాటంగా	బాహాటంగా
baahatangaa	రునో	బాహాటంగా
bahatamga	పికా	బాహాటంగా
bijeegaa	పిచె	బిజీగా
bijiigaa	బిజీగా	బిజీగా
busyga	విచె	బిజీగా
beeru	బీరు	బీరు
biiru	బీరు	బీరు
biru	రు	బీరు
bucchi	తోతో	బుచ్చి
buchchi	జుచె	బుచ్చి
buddha	బుద్ధ	బుద్ధ
budha	బుద్ధ	బుద్ధ
buuddha	బుద్ధ	బుద్ధ
buddha	బుద్ధా	బుద్ధా
buddhaa	లేపి	బుద్ధా
buddhudi	తోలే	బుద్ధుడి
buddhudu	బుద్ధుడు	బుద్ధుడు
buddhuni	బుద్ధుని	బుద్ధుని
budha	పి	బుధ
burrakadha	జుదా	బుర్రకథ
burrakatha	బుర్రకథ	బుర్రకథ
bullodu	బుల్లోడు	బుల్లోడు
bootakapu	తోనో	బూటకపు
butakapu	బూటకపు	బూటకపు
buutakapu	బూటకపు	బూటకపు
bruhat	తో	బృహత్
benajir	నోతో	బెనజీర్
benazir	బెనజీర్	బెనజీర్
beradunu	కాదా	బెరడును
baedi	చె	బేడి
bedi	నో	బేడి
baedii	బేడీ	బేడీ
bedee	నో	బేడీ
bedi	లే	బేడీ
bedii	బేడీ	బేడీ
baetaalha	దా	బేతాళ
betaala	చె	బేతాళ
betala	చె	బేతాళ
baetaalhudu	పిదా	బేతాళుడు
betaaludu	చెదా	బేతాళుడు
betaludu	బేతాళుడు	బేతాళుడు
baesi	చె	బేసి
baesy	లే	బేసి
bassy	జు	బేసి
besi	జు	బేసి
besy	జు	బేసి
baibil	జుదా	బైబిల్
bible	చెపి	బైబిల్
bottutho	బొట్టుతో	బొట్టుతో
bottuto	బొట్టుతో	బొట్టుతో
bomma	దా	బొమ్మ
bommanu	బొమ్మను	బొమ్మను
bommalaata	బొమ్మలాట	బొమ్మలాట
bommalata	బొమ్మలాట	బొమ్మలాట
bommalo	లేపి	బొమ్మలో
bommaloo	విదా	బొమ్మలో
bommallo	బొమ్మల్లో	బొమ్మల్లో
bommalloo	లేరుపి	బొమ్మల్లో
bollaapalli	బొల్లాపల్లి	బొల్లాపల్లి
bodhimchadam	పితో	బోధించడం
bodhinchadam	చెకా	బోధించడం
bodhimchadaaniki	వికారుచె	బోధించడానికి
bodhinchadaaniki	కారుకాపి	బోధించడానికి
bodhinchadaniki	నోకారులే	బోధించడానికి
bodhimchaadu	రునోజు	బోధించాడు
bodhinchaadu	రులేలే	బోధించాడు
boodhinchaadu	బోధించాడు	బోధించాడు
bodhimchindhi	బోధించింది	బోధించింది
bodhimchindi	చెరురు	బోధించింది
bodhinchindi	బోధించింది	బోధించింది
boodhinchindi	చెదాదా	బోధించింది
bodhimchenu	రుతోదా	బోధించెను
bodhinchenu	వివిదా	బోధించెను
boodhinchenu	బోధించెను	బోధించెను
boora	బోర	బోర
bora	చె	బోర
badmeenton	బ్యాడ్మింటన్	బ్యాడ్మింటన్
badminton	బ్యాడ్మింటన్	బ్యాడ్మింటన్
byaadmintan	చెదాలేలే	బ్యాడ్మింటన్
byadmintan	దాపిలేకా	బ్యాడ్మింటన్
brahmaanda	బ్రహ్మాండ	బ్రహ్మాండ
brahmanda	దారుపి	బ్రహ్మాండ
brahmaandamaina	బ్రహ్మాండమైన	బ్రహ్మాండమైన
brahmaandamiena	తోతోతోతో	బ్రహ్మాండమైన
brahmandamaina	బ్రహ్మాండమైన	బ్రహ్మాండమైన
briaan	బ్రియాన్	బ్రియాన్
brian	చెరు	బ్రియాన్
briyaan	జుతో	బ్రియాన్
briyan	బ్రియాన్	బ్రియాన్
blad	బ్లడ్	బ్లడ్
blod	బ్లడ్	బ్లడ్
blood	రు	బ్లడ్
blud	దా	బ్లడ్
bhagavat	పి	భగవత్
bhagavath	చె	భగవత్
bhagawat	భగవత్	భగవత్
bhatnaagar	భట్నాగర్	భట్నాగర్
bhayamoo	జు	భయమూ
bhayamu	భయమూ	భయమూ
bhayamuu	భయమూ	భయమూ
bharata	వి	భరత
bhratha	భరత	భరత
bharathudu	భరతుడు	భరతుడు
bharatudu	జుదా	భరతుడు
bharadhvaajudu	దారుపి	భరద్వాజుడు
bharadwaajudu	భరద్వాజుడు	భరద్వాజుడు
bharadwajudu	వినోలే	భరద్వాజుడు
bharita	భరిత	భరిత
bharitha	తో	భరిత
bhavanam	భవనం	భవనం
bhavanamloki	వినో	భవనంలోకి
bhavananloki	భవనంలోకి	భవనంలోకి
bhavanamloni	భవనంలోని	భవనంలోని
bhavananloni	చెజు	భవనంలోని
bhavanaalaku	పితో	భవనాలకు
bhavanalaku	పినో	భవనాలకు
bhawanaalaku	తోరు	భవనాలకు
bhawanalaku	భవనాలకు	భవనాలకు
bhavanaalanu	భవనాలను	భవనాలను
bhavanalanu	పిపి	భవనాలను
bhawanaalanu	భవనాలను	భవనాలను
bhawanalanu	భవనాలను	భవనాలను
bhavanaalalo	కావి	భవనాలలో
bhavanalalo	భవనాలలో	భవనాలలో
bhawanaalalo	భవనాలలో	భవనాలలో
bhawanalalo	భవనాలలో	భవనాలలో
bhavanaalu	భవనాలు	భవనాలు
bhavanalu	భవనాలు	భవనాలు
bhaagam	భాగం	భాగం
bhagam	వి	భాగం
bhaagamgaa	భాగంగా	భాగంగా
bhaagangaa	భాగంగా	భాగంగా
bhagamgaa	దాజు	భాగంగా
bhaagangaane	వివి	భాగంగానే
bhaahamgaanae	భాగంగానే	భాగంగానే
bhagamgaanay	భాగంగానే	భాగంగానే
bhaagaswaamulaku	భాగస్వాములకు	భాగస్వాములకు
bhagaswamulaku	భాగస్వాములకు	భాగస్వాములకు
bhaagaswaamulu	పికాదా	భాగస్వాములు
bhagaswamulu	భాగస్వాములు	భాగస్వాములు
bhaagaala	లే	భాగాల
bhagala	తో	భాగాల
bhaagaalaku	పిచె	భాగాలకు
bhagalaku	భాగాలకు	భాగాలకు
bhaagaalathoo	భాగాలతో	భాగాలతో
bhaagaalatoe	రుకా	భాగాలతో
bhagalatho	వినో	భాగాలతో
bhaagaalaloe	భాగాలలో	భాగాలలో
bhaagaalaloo	భాగాలలో	భాగాలలో
bhagalalo	భాగాలలో	భాగాలలో
bhaagaale	భాగాలే	భాగాలే
bhagalay	పికా	భాగాలే
bhaagaalaina	భాగాలైన	భాగాలైన
bhagyulyna	భాగాలైన	భాగాలైన
bhaaratadaesamu	భారతదేశము	భారతదేశము
bhaaratadesamu	పిజునో	భారతదేశము
bharathadesam	కాచెచె	భారతదేశము
bhaaratadaesamuloeni	నోచెనోతో	భారతదేశములోని
bharatadesamuloni	లేచెకానో	భారతదేశములోని
bharathadesamulooni	కానోతోరు	భారతదేశములోని
bhaarati	దా	భారతి
bharathi	లే	భారతి
bharati	దా	భారతి
bhaaratheeyula	భారతీయుల	భారతీయుల
bharathiyula	పితో	భారతీయుల
bharatiyula	భారతీయుల	భారతీయుల
bhaaratheeyulandharikee	రుచెజునో	భారతీయులందరికీ
bharathiyulandhariki	తోచెచెలే	భారతీయులందరికీ
bharatiyulandariki	నోపిచెనో	భారతీయులందరికీ
bhaaratheeyulatho	విరుతో	భారతీయులతో
bharateeyulatoo	నోరుజు	భారతీయులతో
bharatiyulato	జుతోలే	భారతీయులతో
bhaaratheeyulapai	కాలేనో	భారతీయులపై
bharateeyulapai	భారతీయులపై	భారతీయులపై
bharatiiyulapai	జునోవి	భారతీయులపై
bharatiyulapie	భారతీయులపై	భారతీయులపై
bhaavaalanu	పినో	భావాలను
bhavalanu	తోచె	భావాలను
bhaavinchevaaru	భావించేవారు	భావించేవారు
bhavincheevaru	నోకాలే	భావించేవారు
bhavinchevaru	నోచెజు	భావించేవారు
bhaashallo	పినో	భాషల్లో
bhaashalloe	పిజు	భాషల్లో
bhaashalloo	చెజు	భాషల్లో
bheemili	భీమిలి	భీమిలి
bhiimili	పిపి	భీమిలి
bheeshmudiki	కారుదా	భీష్ముడికి
bhiishmudiki	విలేదా	భీష్ముడికి
bhishmudiki	భీష్ముడికి	భీష్ముడికి
bhujangaraavu	భుజంగరావు	భుజంగరావు
bhoobhaagaaniki	కాపిదా	భూభాగానికి
bhuubhaagaaniki	రుదాతో	భూభాగానికి
bhuugaanaaniki	దాలేదా	భూభాగానికి
bhoobhaagaanni	భూభాగాన్ని	భూభాగాన్ని
bhuubhaagaanni	భూభాగాన్ని	భూభాగాన్ని
bhoobhaagaalanu	వినోకా	భూభాగాలను
bhuubhaagaalanu	జురునో	భూభాగాలను
bhuubhaalanu	విపిచె	భూభాగాలను
bhummida	భూమ్మీద	భూమ్మీద
bhuummeeda	భూమ్మీద	భూమ్మీద
bhuummida	భూమ్మీద	భూమ్మీద
bhoolookamloo	జుతో	భూలోకంలో
bhulokamlo	జునో	భూలోకంలో
bhuuloekamloe	రుదా	భూలోకంలో
bhoolookamloo	నోనోవి	భూలోకములో
bhulokamulo	కాజునో	భూలోకములో
bhuuloekamuloe	భూలోకములో	భూలోకములో
bhoolookaaniki	విజునో	భూలోకానికి
bhulokaaniki	భూలోకానికి	భూలోకానికి
bhuuloekaaniki	భూలోకానికి	భూలోకానికి
bheeri	తో	భేరి
bheri	జు	భేరి
bhauthikangaa	చెదా	భౌతికంగా
bhouthikamga	భౌతికంగా	భౌతికంగా
boutikangaa	కారు	భౌతికంగా
mangalampalli	విపిపి	మంగళంపల్లి
mangalapalli	నోజుచె	మంగళంపల్లి
mamtapamu	పివి	మంటపము
mantapamu	దారు	మంటపము
mandalamu	మండలము	మండలము
mandalamulo	నోకా	మండలములో
mandalamuloo	మండలములో	మండలములో
mandalamuloni	మండలములోని	మండలములోని
mandalamulooni	పిలేనో	మండలములోని
manthrithva	పిలేలే	మంత్రిత్వ
mantritwa	జునోతో	మంత్రిత్వ
mamda	చె	మంద
mamdha	నో	మంద
manda	తో	మంద
mamdamgaa	మందంగా	మందంగా
mamdhamgaa	రుతో	మందంగా
mandamga	మందంగా	మందంగా
mamdhamaina	రుజు	మందమైన
mandamaina	తోతో	మందమైన
mandhamaina	మందమైన	మందమైన
mamdhalu	జు	మందలు
mandalu	మందలు	మందలు
mandhalu	తో	మందలు
mandhaara	మందార	మందార
mandhaaram	తోతో	మందారం
mamdugaa	మందుగా	మందుగా
mandhugaa	చెవి	మందుగా
mandugaa	నోజు	మందుగా
mamduni	మందుని	మందుని
mandhuni	నోదా	మందుని
manduni	వినో	మందుని
mamdunu	వినో	మందును
mandunu	లేపి	మందును
mamdulanu	చెకా	మందులను
mandulanu	మందులను	మందులను
mamdulu	మందులు	మందులు
mandulu	చెవి	మందులు
mamdae	దా	మందే
mande	మందే	మందే
mandee	జు	మందే
makaramda	మకరంద	మకరంద
makaranda	తో	మకరంద
magada	మగడా	మగడా
magadaa	మగడా	మగడా
magadu	మగడు	మగడు
magavaalhlhu	మగవాళ్ళు	మగవాళ్ళు
magavaallu	మగవాళ్ళు	మగవాళ్ళు
maggam	మగ్గం	మగ్గం
maggaalu	విచె	మగ్గాలు
maggalu	దాచె	మగ్గాలు
magguthunna	తోదాచె	మగ్గుతున్న
maggutunna	మగ్గుతున్న	మగ్గుతున్న
macchika	తోలే	మచ్చిక
machchika	మచ్చిక	మచ్చిక
machhuka	వివి	మచ్చిక
matamlo	చె	మఠంలో
mathamlo	మఠంలో	మఠంలో
mattamloo	పి	మఠంలో
madona	మడోన్నా	మడోన్నా
madonna	మడోన్నా	మడోన్నా
madonnaa	దాలే	మడోన్నా
madoonnaa	మడోన్నా	మడోన్నా
maddi	కా	మడ్డి
manhikanta	మణికంఠ	మణికంఠ
manhikantha	మణికంఠ	మణికంఠ
manikanta	కారు	మణికంఠ
matastula	విచె	మతస్తుల
mathasthula	కాజు	మతస్తుల
mataachaaraalanu	మతాచారాలను	మతాచారాలను
matacharalanu	లేతోదా	మతాచారాలను
mathaachaaraalanu	రుతోవి	మతాచారాలను
madraasuku	మద్రాసుకు	మద్రాసుకు
madrasuku	మద్రాసుకు	మద్రాసుకు
madraasuloo	మద్రాసులో	మద్రాసులో
madrasulo	తోనోజు	మద్రాసులో
manasantaa	మనసంతా	మనసంతా
manasanthaa	మనసంతా	మనసంతా
manasuku	వితో	మనసుకు
manasutho	మనసుతో	మనసుతో
manasuto	మనసుతో	మనసుతో
manasutoe	జురు	మనసుతో
manasuna	మనసున	మనసున
manasuni	మనసుని	మనసుని
manasunna	పినో	మనసున్న
manasulanu	దాతో	మనసులను
manasulu	మనసులు	మనసులు
manasuloenae	రురు	మనసులోనే
manasulone	చెకా	మనసులోనే
manasuloonee	లేలే	మనసులోనే
manugada	చె	మనుగడ
manugadaku	నోలే	మనుగడకు
manugadalo	వితో	మనుగడలో
manugadaloe	మనుగడలో	మనుగడలో
manushya	మనుష్య	మనుష్య
manoemaya	లే	మనోమయ
manomaya	తో	మనోమయ
manoomaya	మనోమయ	మనోమయ
mannanalu	మన్ననలు	మన్ననలు
manro	వి	మన్రో
manroe	నో	మన్రో
monroe	రు	మన్రో
mammi	లే	మమ్మీ
mammy	మమ్మీ	మమ్మీ
mamy	మమ్మీ	మమ్మీ
mommi	పి	మమ్మీ
mommy	చె	మమ్మీ
momy	మమ్మీ	మమ్మీ
mummi	చె	మమ్మీ
mummy	వి	మమ్మీ
mumy	మమ్మీ	మమ్మీ
muummy	నో	మమ్మీ
mayam	మయం	మయం
mayi	మయి	మయి
mayooram	కా	మయూరం
mayuuram	లే	మయూరం
marakalu	తో	మరకలు
maripeda	మరిపెడ	మరిపెడ
maroka	లే	మరోక
marooka	మరోక	మరోక
malachi	మలచి	మలచి
malchi	మలచి	మలచి
malamoo	దా	మలము
malamu	మలము	మలము
malayaala	మలయాళ	మలయాళ
malayaalha	జు	మలయాళ
malayalee	మలయాళ	మలయాళ
malayali	మలయాళ	మలయాళ
mavuthundhi	మవుతుంది	మవుతుంది
mavuthundi	చెరు	మవుతుంది
mavutundi	పిజు	మవుతుంది
mashoochi	దా	మశూచి
mashuchi	జు	మశూచి
masoochi	చె	మశూచి
mahattara	తోరు	మహత్తర
mahatthara	లేపి	మహత్తర
mahaadevi	రుకా	మహాదేవి
mahaadhevi	లేవి	మహాదేవి
mahadevi	నోజు	మహాదేవి
mahaanubhaavudu	మహానుభావుడు	మహానుభావుడు
mahanubhavudu	జుకాకా	మహానుభావుడు
mahaapandithudu	మహాపండితుడు	మహాపండితుడు
mahapanditudu	మహాపండితుడు	మహాపండితుడు
mahabharatamu	జుకారు	మహాభారతము
mahabharathamu	తోవికా	మహాభారతము
mahaabhaarathaanni	మహాభారతాన్ని	మహాభారతాన్ని
mahabharathanni	వికాలేలే	మహాభారతాన్ని
mahaamuni	జుపి	మహాముని
mahamuni	మహాముని	మహాముని
mahaalakshmi	మహాలక్ష్మి	మహాలక్ష్మి
mahalakshmi	కాతోరు	మహాలక్ష్మి
mahaalaya	నో	మహాలయ
mahalaya	మహాలయ	మహాలయ
mahaavishnuvu	మహావిష్ణువు	మహావిష్ణువు
mahavishnuvu	దాపిజు	మహావిష్ణువు
mahotsavam	మహోత్సవం	మహోత్సవం
mahotsavaalu	జుకాతో	మహోత్సవాలు
mahotsavalu	మహోత్సవాలు	మహోత్సవాలు
maanthrika	విదా	మాంత్రిక
maantrika	మాంత్రిక	మాంత్రిక
manthrika	మాంత్రిక	మాంత్రిక
mantrika	మాంత్రిక	మాంత్రిక
maanthrikulu	మాంత్రికులు	మాంత్రికులు
maantrikulu	మాంత్రికులు	మాంత్రికులు
manthrikulu	దాపిపి	మాంత్రికులు
maatrices	లేలేపి	మాట్రిక్స్
matrices	మాట్రిక్స్	మాట్రిక్స్
metrices	మాట్రిక్స్	మాట్రిక్స్
maathyuu	కావి	మాథ్యూ
maatthew	వికా	మాథ్యూ
mathew	మాథ్యూ	మాథ్యూ
matthew	మాథ్యూ	మాథ్యూ
metthew	మాథ్యూ	మాథ్యూ
maathyoos	రుజు	మాథ్యూస్
mathews	చెచె	మాథ్యూస్
maadhava	జు	మాధవ
maadhava	మాధవా	మాధవా
maadhavaa	మాధవా	మాధవా
maana	మాన	మాన
mana	మాన	మాన
maanusha	పి	మానుష
maafia	దాతో	మాఫియా
mafia	లేచె	మాఫియా
maphia	మాఫియా	మాఫియా
maarutee	తోకా	మారుతీ
maaruthi	మారుతీ	మారుతీ
maarutii	వివి	మారుతీ
maruthee	మారుతీ	మారుతీ
maaruteeravu	మారుతీరావు	మారుతీరావు
maaruthiravu	చెకాలే	మారుతీరావు
maruthirao	తోచెతో	మారుతీరావు
marutirao	జుదారు	మారుతీరావు
maare	మారే	మారే
maree	లే	మారే
maargamlone	మార్గంలోనే	మార్గంలోనే
margamlone	మార్గంలోనే	మార్గంలోనే
maarchataaniki	రుతోపి	మార్చటానికి
maarchataniki	విపిదా	మార్చటానికి
marchataniki	రుతోతో	మార్చటానికి
maarchadaaniki	విలేలే	మార్చడానికి
maarchadaniki	నోలేపి	మార్చడానికి
marchadaniki	తోనోచె	మార్చడానికి
maarchaadu	నోవి	మార్చాడు
marchadu	చెచె	మార్చాడు
maarchaalani	మార్చాలని	మార్చాలని
marchalani	రునోకా	మార్చాలని
maarchae	విలే	మార్చే
maarche	దాపి	మార్చే
marche	మార్చే	మార్చే
maarchaenduku	మార్చేందుకు	మార్చేందుకు
maarchenduku	మార్చేందుకు	మార్చేందుకు
marchenduku	మార్చేందుకు	మార్చేందుకు
maarch	పివి	మార్చ్
march	మార్చ్	మార్చ్
maart	మార్ట్	మార్ట్
mart	మార్ట్	మార్ట్
maartial	లేకా	మార్షల్
marshal	లేదా	మార్షల్
marshall	తోలే	మార్షల్
martial	మార్షల్	మార్షల్
maalaa	దా	మాలా
mala	మాలా	మాలా
maali	చె	మాలి
mali	రు	మాలి
maalavika	మాళవిక	మాళవిక
malavika	కావి	మాళవిక
maasam	చె	మాసం
masam	నో	మాసం
maasamulu	తోలే	మాసములు
masamalu	తోనో	మాసములు
mickei	పినో	మిక్కీ
mickey	రుపి	మిక్కీ
micqey	మిక్కీ	మిక్కీ
miickey	మిక్కీ	మిక్కీ
mikkee	మిక్కీ	మిక్కీ
mikkey	జుచె	మిక్కీ
mikki	విలే	మిక్కీ
migita	లేజు	మిగితా
migitaa	రురు	మిగితా
migithaa	మిగితా	మిగితా
mittal	విచె	మిట్టల్
mishatho	జు	మిషతో
mishathoo	మిషతో	మిషతో
mishato	వి	మిషతో
meekantae	మీకంటే	మీకంటే
meekante	మీకంటే	మీకంటే
meeku	మీకు	మీకు
meekunna	మీకున్న	మీకున్న
meetarla	వికా	మీటర్ల
meetarlalo	మీటర్లలో	మీటర్లలో
meetarlaloo	మీటర్లలో	మీటర్లలో
meemaamsa	మీమాంస	మీమాంస
meemaamsaku	పిజు	మీమాంసకు
meemamsaku	మీమాంసకు	మీమాంసకు
meeroo	రు	మీరూ
meeru	మీరూ	మీరూ
meeruu	మీరూ	మీరూ
miiruu	వి	మీరూ
mundhumaatalo	ముందుమాటలో	ముందుమాటలో
mundhumaataloo	రుచెదా	ముందుమాటలో
mundhumatalo	ముందుమాటలో	ముందుమాటలో
mundumaataloo	దాలేచె	ముందుమాటలో
mumbailo	లేదా	ముంబైలో
mumbailoo	ముంబైలో	ముంబైలో
mukkalo	కాజు	ముక్కలో
mukkaloo	జుచె	ముక్కలో
mukthyala	దాలేవి	ముక్త్యాల
muktyaala	విపితో	ముక్త్యాల
mukytala	పినోతో	ముక్త్యాల
mudipadi	నోలే	ముడిపడి
muthyaala	కానో	ముత్యాల
mutyala	విపి	ముత్యాల
muthyaalanu	ముత్యాలను	ముత్యాలను
muthyalanu	ముత్యాలను	ముత్యాలను
mutyalanu	లేపిపి	ముత్యాలను
muthyaalu	ముత్యాలు	ముత్యాలు
mutyaalu	పిచె	ముత్యాలు
mutyalu	జులే	ముత్యాలు
munagaala	మునగాల	మునగాల
munagala	రులే	మునగాల
munupe	తోపి	మునుపే
minsipal	మున్సిపల్	మున్సిపల్
muncipal	దాదాపి	మున్సిపల్
municipal	మున్సిపల్	మున్సిపల్
munsipal	జునోవి	మున్సిపల్
muppu	ముప్పు	ముప్పు
muppunu	లేరు	ముప్పును
muppai	పిరు	ముప్ఫై
mupphi	వితో	ముప్ఫై
murise	మురిసే	మురిసే
mulla	ముళ్ల	ముళ్ల
mullu	విలే	ముళ్లు
muslim	ముస్లిం	ముస్లిం
muslimlu	ముస్లింలు	ముస్లింలు
moodadugula	మూడడుగుల	మూడడుగుల
mudadugula	తోదా	మూడడుగుల
murti	కావి	మూర్తి
muurti	జుచె	మూర్తి
murtini	చెజు	మూర్తిని
muurtini	మూర్తిని	మూర్తిని
muulamgaanae	మూలంగానే	మూలంగానే
muulamgaanee	తోవి	మూలంగానే
muulangaane	మూలంగానే	మూలంగానే
moolaalaku	మూలాలకు	మూలాలకు
muulaalaku	మూలాలకు	మూలాలకు
moolaalanu	కాదా	మూలాలను
muulaalanu	మూలాలను	మూలాలను
moolika	మూలిక	మూలిక
muulika	రు	మూలిక
moolikala	మూలికల	మూలికల
muulikala	మూలికల	మూలికల
moolikalanu	నోజు	మూలికలను
muulikalanu	దాచె	మూలికలను
moolikaa	కారు	మూలికా
muulikaa	మూలికా	మూలికా
mooshaaru	కాతో	మూశారు
musharu	దాపి	మూశారు
muushaaru	మూశారు	మూశారు
mooseeki	మూసీకి	మూసీకి
muuseeki	దానో	మూసీకి
muusiiki	తోనో	మూసీకి
mrhugaala	లే	మృగాల
mrugaala	రు	మృగాల
medicines	మెడిసిన్స్	మెడిసిన్స్
medisins	మెడిసిన్స్	మెడిసిన్స్
mailing	మెయిలింగ్	మెయిలింగ్
meyilimg	మెయిలింగ్	మెయిలింగ్
meyiling	లేదాచె	మెయిలింగ్
meeghamaa	మేఘమా	మేఘమా
meghamaa	చె	మేఘమా
maeda	లే	మేడ
meda	మేడ	మేడ
meeda	మేడ	మేడ
maedae	మేడే	మేడే
maede	కా	మేడే
mayday	రు	మేడే
mede	మేడే	మేడే
maeta	లే	మేత
meta	మేత	మేత
metha	రు	మేత
matho	మేథో	మేథో
mathoo	మేథో	మేథో
metho	మేథో	మేథో
methoo	తో	మేథో
medassu	పినో	మేధస్సు
medhassu	చెవి	మేధస్సు
medhassuku	జువిచె	మేధస్సుకు
maedhassunu	కారుదా	మేధస్సును
medhassunu	చెనోరు	మేధస్సును
maethoo	లే	మేధో
medho	దా	మేధో
meedhoo	మేధో	మేధో
mayaru	మేయరు	మేయరు
mayoru	మేయరు	మేయరు
mera	రు	మేర
mestay	మేస్తే	మేస్తే
meste	జుదా	మేస్తే
mestee	రునో	మేస్తే
main	లే	మైన్
maine	మైన్	మైన్
mine	మైన్	మైన్
myne	మైన్	మైన్
mailuraayi	లేదా	మైలురాయి
mailurayi	మైలురాయి	మైలురాయి
mieluraayi	కారు	మైలురాయి
miluraayi	మైలురాయి	మైలురాయి
moghalula	మొఘలుల	మొఘలుల
moghalulu	జులే	మొఘలులు
moghululu	మొఘలులు	మొఘలులు
moddu	నోజు	మొద్దు
molakalu	నోనో	మొలకలు
moolakalu	కాచె	మొలకలు
mota	దా	మోట
moetae	మోతే	మోతే
moote	రు	మోతే
motae	చె	మోతే
mote	మోతే	మోతే
moosaginchadam	వితోచె	మోసగించడం
mosaginchadam	విజుజు	మోసగించడం
moesae	తో	మోసే
mosae	లే	మోసే
mose	తో	మోసే
moseey	చె	మోసే
mosei	వి	మోసే
mosey	మోసే	మోసే
mat	చెదా	మ్యాట్
matt	మ్యాట్	మ్యాట్
mucous	చెవి	మ్యూకస్
mucus	నోపి	మ్యూకస్
yajamaanulaku	చెచెజు	యజమానులకు
yajamanulaku	చెదానో	యజమానులకు
yajamaanulu	పిదా	యజమానులు
yadala	పి	యడల
yatha	యథా	యథా
yathaa	కా	యథా
yamakinkarulu	యమకింకరులు	యమకింకరులు
yaantrika	యాంత్రిక	యాంత్రిక
yantrika	యాంత్రిక	యాంత్రిక
yaantrikamaina	జునోలే	యాంత్రికమైన
yaantrikamiena	యాంత్రికమైన	యాంత్రికమైన
yantrikamaina	యాంత్రికమైన	యాంత్రికమైన
yaajamaanyam	యాజమాన్యం	యాజమాన్యం
yajamanyam	కాలేతో	యాజమాన్యం
yaajamaanyaaniki	యాజమాన్యానికి	యాజమాన్యానికి
yajamanyaniki	చెదాపివి	యాజమాన్యానికి
yaajamaanyaanni	యాజమాన్యాన్ని	యాజమాన్యాన్ని
yaajamanyaanni	నోతోజుతో	యాజమాన్యాన్ని
yajamanyanni	యాజమాన్యాన్ని	యాజమాన్యాన్ని
yaajamaanyaalu	చెదాజు	యాజమాన్యాలు
yajamanyalu	యాజమాన్యాలు	యాజమాన్యాలు
acid	విజు	యాసిడ్
yaasid	పిదా	యాసిడ్
echchae	యిచ్చే	యిచ్చే
icche	విపి	యిచ్చే
yecche	యిచ్చే	యిచ్చే
yichhe	నోతో	యిచ్చే
yugamdhar	విలే	యుగంధర్
yugandhar	కారు	యుగంధర్
yuddha	యుద్ధ	యుద్ధ
yuddhaalu	చెతో	యుద్ధాలు
yudhalu	తోపి	యుద్ధాలు
yuvata	యువత	యువత
yuvatha	జు	యువత
yuvataku	చెవి	యువతకు
yuvathaku	నోరు	యువతకు
yuvatanu	నోతో	యువతను
yuvathanu	యువతను	యువతను
yuvataloe	వినో	యువతలో
yuvataloo	దాలే	యువతలో
yuvathalo	రుతో	యువతలో
yuvathulu	విజు	యువతులు
yuvatulu	తోనో	యువతులు
your	చె	యువర్
youur	కా	యువర్
yuvar	యువర్	యువర్
universiteelo	యూనివర్శిటీలో	యూనివర్శిటీలో
universitylo	యూనివర్శిటీలో	యూనివర్శిటీలో
yoonivarsiteelo	యూనివర్శిటీలో	యూనివర్శిటీలో
yehova	పిపి	యెహోవా
yehovaa	చెజు	యెహోవా
yetara	యేతర	యేతర
yethara	యేతర	యేతర
yerpaatu	జుతో	యేర్పాటు
yeyrpaatu	కానో	యేర్పాటు
yogulu	జుపి	యోగులు
yoogulu	పిపి	యోగులు
rangamma	కాతో	రంగమ్మ
rangaallo	రంగాల్లో	రంగాల్లో
rangaalloo	దాకా	రంగాల్లో
ramdani	తో	రండని
randani	రండని	రండని
rakamagaanu	రకంగానూ	రకంగానూ
rakamgaanoo	రకంగానూ	రకంగానూ
rakanganuu	రకంగానూ	రకంగానూ
rakaallo	రకాల్లో	రకాల్లో
rakalloo	కానో	రకాల్లో
rakkallo	రకాల్లో	రకాల్లో
raktamu	దారు	రక్తము
raktamunu	నోజు	రక్తమును
raktaheenatha	లేతో	రక్తహీనత
raktahinatha	చెపి	రక్తహీనత
rakthahenatha	దానో	రక్తహీనత
raktaaniki	రక్తానికి	రక్తానికి
raktaniki	రక్తానికి	రక్తానికి
rakthaniki	దానోదా	రక్తానికి
raktaanni	తోజువి	రక్తాన్ని
raktanni	జురునో	రక్తాన్ని
rakthanni	రక్తాన్ని	రక్తాన్ని
rakshakudu	నోపి	రక్షకుడు
rakshana	రు	రక్షణ
rakshanha	రు	రక్షణ
rakshanaga	చెపి	రక్షణగా
rakshanagaa	రక్షణగా	రక్షణగా
rakshanhagaa	నోచె	రక్షణగా
rakshinchataaniki	దారురువి	రక్షించటానికి
rakshinchataniki	రక్షించటానికి	రక్షించటానికి
rakshinchadam	రక్షించడం	రక్షించడం
rakshinchadaniki	లేవిజునో	రక్షించడానికి
rakshinchamani	రక్షించమని	రక్షించమని
rakshincharu	కాకాలే	రక్షించారు
rakshinchharu	విజులే	రక్షించారు
rakshinchaali	రుజుతో	రక్షించాలి
rakshinchali	దాలేరు	రక్షించాలి
rakshinche	రక్షించే	రక్షించే
ragada	పి	రగడ
rachanala	రచనల	రచనల
rachanalathoo	పిచె	రచనలతో
rachanalanu	కాకా	రచనలను
rachanalapai	నోతో	రచనలపై
rachanalapy	రచనలపై	రచనలపై
rathi	వి	రతి
rattaiah	కాకా	రత్తయ్య
rattayya	రత్తయ్య	రత్తయ్య
ratthayya	దాతో	రత్తయ్య
rathna	రత్న	రత్న
rathnaaniki	దాజుపి	రత్నానికి
rathnaalu	రత్నాలు	రత్నాలు
rabbar	తోలే	రబ్బర్
rubbar	కావి	రబ్బర్
rubber	రబ్బర్	రబ్బర్
ruber	రబ్బర్	రబ్బర్
ruubber	వివి	రబ్బర్
ravika	వి	రవిక
ravivarma	జుకా	రవివర్మ
rashyan	రష్యన్	రష్యన్
russian	లేరు	రష్యన్
ruussian	చెవి	రష్యన్
rasamaya	రసమయి	రసమయి
rasamayi	వి	రసమయి
rahasya	రహస్య	రహస్య
rahasyamgaa	రహస్యంగా	రహస్యంగా
rahasyanga	రహస్యంగా	రహస్యంగా
rahasyamu	దాతో	రహస్యము
rahasyamuga	రుజుజు	రహస్యముగా
rahasyamugaa	రహస్యముగా	రహస్యముగా
rahasyaanni	కానోదా	రహస్యాన్ని
rahasyanni	రుకానో	రహస్యాన్ని
rahasyaalanu	రుకాతో	రహస్యాలను
rahasyalanu	రహస్యాలను	రహస్యాలను
raajamamdri	రాజమండ్రి	రాజమండ్రి
raajamandri	జురుకా	రాజమండ్రి
rajahmundry	రాజమండ్రి	రాజమండ్రి
rajamandri	రాజమండ్రి	రాజమండ్రి
raajamamdriki	రాజమండ్రికి	రాజమండ్రికి
raajamandriki	చెలేనో	రాజమండ్రికి
rajahmundryki	రాజమండ్రికి	రాజమండ్రికి
rajamandriki	చెచెరు	రాజమండ్రికి
raajamamdrini	వివిదా	రాజమండ్రిని
raajamandrini	పిచెవి	రాజమండ్రిని
rajahmundryni	రాజమండ్రిని	రాజమండ్రిని
rajamandrini	దాతోజు	రాజమండ్రిని
raajamaatha	చెచె	రాజమాత
rajamata	రాజమాత	రాజమాత
raajayyanu	నోదా	రాజయ్యను
rajayyanu	రాజయ్యను	రాజయ్యను
raajayyaadu	రాజయ్యాడు	రాజయ్యాడు
rajayyaadu	రాజయ్యాడు	రాజయ్యాడు
rajayyadu	దాలేకా	రాజయ్యాడు
raajyamu	రాజ్యము	రాజ్యము
rajyamu	రాజ్యము	రాజ్యము
raajyamunu	రాజ్యమును	రాజ్యమును
rajyamunu	రాజ్యమును	రాజ్యమును
raajyasabha	రాజ్యసభ	రాజ్యసభ
raajyasabhaku	జుదారు	రాజ్యసభకు
raajyasabhalo	రాజ్యసభలో	రాజ్యసభలో
raajayyaniki	రువిలే	రాజ్యానికి
raajyaaniki	రాజ్యానికి	రాజ్యానికి
rajyaniki	తోవిజు	రాజ్యానికి
raadu	రాడు	రాడు
radu	దా	రాడు
raadha	చె	రాధ
radha	రాధ	రాధ
raadhaku	దా	రాధకు
radhaku	వి	రాధకు
raadhatho	రాధతో	రాధతో
radhatho	రాధతో	రాధతో
radhato	దా	రాధతో
raanaa	దా	రానా
rana	పి	రానా
raani	చె	రాని
rani	చె	రాని
raapid	కావి	రాపిడ్
rapid	వివి	రాపిడ్
raamasya	రామస్య	రామస్య
raamaayanam	నోకా	రామాయణం
ramayanam	కావి	రామాయణం
raamaayanamlo	జువితో	రామాయణంలో
ramayanamlo	కాలేవి	రామాయణంలో
rayabaram	రాయబారం	రాయబారం
raayi	రాయి	రాయి
rayi	చె	రాయి
roy	పి	రాయి
raayigaa	రాయిగా	రాయిగా
rayiga	రాయిగా	రాయిగా
raayitho	లేదా	రాయితో
raayitoo	రాయితో	రాయితో
raalla	రాళ్ళ	రాళ్ళ
ralla	లే	రాళ్ళ
raallatho	రాళ్ళతో	రాళ్ళతో
raallato	పిపి	రాళ్ళతో
rallatho	రాళ్ళతో	రాళ్ళతో
rallato	రాళ్ళతో	రాళ్ళతో
raallapalli	దాజుదా	రాళ్ళపల్లి
rallapalli	రాళ్ళపల్లి	రాళ్ళపల్లి
raavutho	విరు	రావుతో
raavuto	దాతో	రావుతో
ravutho	పినో	రావుతో
ravuto	రావుతో	రావుతో
raavo	రావో	రావో
ravo	లే	రావో
raasulu	పివి	రాశులు
rashulu	రాశులు	రాశులు
rasulu	రాశులు	రాశులు
raashtramloni	కాతోకాలే	రాష్ట్రంలోని
rashtramloni	వినోరుదా	రాష్ట్రంలోని
rashtranloni	రులేలేకా	రాష్ట్రంలోని
rashtramlone	నోరుజుకా	రాష్ట్రంలోనే
rashtranlone	తోనోరుజు	రాష్ట్రంలోనే
raasaaru	విదా	రాసారు
rasaru	పిరు	రాసారు
raasee	రు	రాసి
raasi	రాసి	రాసి
rasi	రాసి	రాసి
raasindi	నోచె	రాసింది
rasindi	తోనో	రాసింది
raasenduku	చెతోలే	రాసేందుకు
rasenduku	నోరుతో	రాసేందుకు
raahu	రాహు	రాహు
rahu	జు	రాహు
recommend	రికమెండ్	రికమెండ్
richa	దా	రిచా
richaa	రిచా	రిచా
resarvation	రిజర్వేషన్	రిజర్వేషన్
reservation	తోలేతో	రిజర్వేషన్
rijarveshan	రిజర్వేషన్	రిజర్వేషన్
rijarvaeshanla	నోకాచె	రిజర్వేషన్ల
rijarveshanla	రిజర్వేషన్ల	రిజర్వేషన్ల
reserve	వినో	రిజర్వ్
rijarv	కాచె	రిజర్వ్
retired	రిటైర్డ్	రిటైర్డ్
retail	రిటైల్	రిటైల్
retel	లేనో	రిటైల్
runaalanu	రుణాలను	రుణాలను
runalanu	రుణాలను	రుణాలను
rudhraa	రుద్రా	రుద్రా
rudra	రుద్రా	రుద్రా
rudraa	నోకా	రుద్రా
rudhruni	కారు	రుద్రుని
rudruni	రుద్రుని	రుద్రుని
rudhruniki	కాతోనో	రుద్రునికి
rudruniki	రుద్రునికి	రుద్రునికి
rudhrulaku	రుతోచె	రుద్రులకు
rudrulaku	రుద్రులకు	రుద్రులకు
roopamai	జు	రూపమై
rupamai	జు	రూపమై
remdu	రెండు	రెండు
rendu	వి	రెండు
remduna	రెండున	రెండున
renduna	రెండున	రెండున
remdunu	పినో	రెండును
rendunu	రుదా	రెండును
rendaella	రెండేళ్ళ	రెండేళ్ళ
rendella	రెండేళ్ళ	రెండేళ్ళ
rendaellu	జుచెవి	రెండేళ్ళు
rendellu	వివిజు	రెండేళ్ళు
range	రు	రేంజ్
ranje	రేంజ్	రేంజ్
renge	లే	రేంజ్
raetlaku	రేట్లకు	రేట్లకు
ratelaku	విజు	రేట్లకు
reetlaku	రేట్లకు	రేట్లకు
raetlanu	చెతో	రేట్లను
ratelanu	చెరు	రేట్లను
raepati	లే	రేపటి
repati	రేపటి	రేపటి
royyala	లేనో	రొయ్యల
royyalu	రుకా	రొయ్యలు
roganni	పినో	రోగాన్ని
roogaanni	దాతో	రోగాన్ని
rooganni	లేదా	రోగాన్ని
rogalu	పితో	రోగాలు
roogaalu	తోరు	రోగాలు
roogalu	రోగాలు	రోగాలు
rojuluga	జులే	రోజులుగా
rojulugaa	రోజులుగా	రోజులుగా
roojulugaa	రోజులుగా	రోజులుగా
roadlu	రోడ్లు	రోడ్లు
roodlu	రోడ్లు	రోడ్లు
rhodes	పితో	రోడ్స్
roades	రోడ్స్	రోడ్స్
roads	రుతో	రోడ్స్
roods	విజు	రోడ్స్
roling	కాజు	రోలింగ్
rolling	రోలింగ్	రోలింగ్
rooling	రోలింగ్	రోలింగ్
rallylu	రుకా	ర్యాలీలు
ryaaleelu	నోతో	ర్యాలీలు
ryalilu	ర్యాలీలు	ర్యాలీలు
rallyloo	పికా	ర్యాలీలో
ryaaleeloo	ర్యాలీలో	ర్యాలీలో
ryalilo	తోజు	ర్యాలీలో
lucki	చె	లక్కీ
lucky	లక్కీ	లక్కీ
luckyi	లక్కీ	లక్కీ
lucqy	లక్కీ	లక్కీ
lukky	లక్కీ	లక్కీ
luucky	లక్కీ	లక్కీ
lakshaku	దానో	లక్షకు
lakshanamulanu	పిచెపి	లక్షణములను
lakshanhamulanu	లక్షణములను	లక్షణములను
lagu	తో	లగు
lagnasdha	కాచె	లగ్నస్థ
lagnastha	లగ్నస్థ	లగ్నస్థ
laantide	రుకా	లాంటిదే
laantidhe	లాంటిదే	లాంటిదే
lantide	లాంటిదే	లాంటిదే
laagadam	వి	లాగడం
laahiri	లాహిరి	లాహిరి
lahiri	రుజు	లాహిరి
lincoln	లింకన్	లింకన్
lincon	లింకన్	లింకన్
linkan	లింకన్	లింకన్
lingamu	జుపి	లింగము
lingamunu	లింగమును	లింగమును
lingamulu	కాకా	లింగములు
lipiki	లిపికి	లిపికి
leelaavathi	వివి	లీలావతి
leelaavati	లీలావతి	లీలావతి
leelavathi	దాకా	లీలావతి
lekkana	తోకా	లెక్కన
lekkalu	చెవి	లెక్కలు
lekkallo	లెక్కల్లో	లెక్కల్లో
lekkalloo	నోదాతో	లెక్కల్లో
ledane	దా	లేదనే
ledhane	లేదనే	లేదనే
laedhuraa	రుచె	లేదురా
leduraa	లేలే	లేదురా
leedhuraa	పిదా	లేదురా
laedho	నో	లేదో
ledo	లేదో	లేదో
leedhoo	తో	లేదో
laenatuvanti	లేనటువంటి	లేనటువంటి
leenatuvamti	లేనటువంటి	లేనటువంటి
laen	వి	లేన్
lane	నో	లేన్
layn	దా	లేన్
leann	లేన్	లేన్
lein	లేన్	లేన్
len	లేన్	లేన్
leamu	లేము	లేము
lemu	చె	లేము
lerani	లేరని	లేరని
laeraa	లేరా	లేరా
leara	చె	లేరా
leraa	కా	లేరా
lokamu	లోకము	లోకము
lokamulaku	వినో	లోకములకు
lokamulu	పితో	లోకములు
laogan	తోచె	లోగాన్
loegaan	లోగాన్	లోగాన్
logaan	దాపి	లోగాన్
logan	లోగాన్	లోగాన్
logen	లేవి	లోగాన్
loehamtoe	లోహంతో	లోహంతో
lohamtho	నోపి	లోహంతో
lohamthoo	దారు	లోహంతో
lohamtoe	పినో	లోహంతో
loehit	కానో	లోహిత్
lohit	దాపి	లోహిత్
lohith	నోరు	లోహిత్
loehiyaa	రువి	లోహియా
lohiya	లోహియా	లోహియా
lohiyaa	లేపి	లోహియా
laab	ల్యాబ్	ల్యాబ్
lab	ల్యాబ్	ల్యాబ్
vamtakaalanu	దాచె	వంటకాలను
vantakaalanu	వంటకాలను	వంటకాలను
vamtakaalu	రుదా	వంటకాలు
vantakaalu	నోవి	వంటకాలు
vantivi	వంటివి	వంటివి
vandina	వండిన	వండిన
vamsiiyulu	వంశీయులు	వంశీయులు
vamsiyulu	వంశీయులు	వంశీయులు
vaktalu	విలే	వక్తలు
vattidito	వత్తిడితో	వత్తిడితో
vattiditoe	వత్తిడితో	వత్తిడితో
vattiditoo	చెతోవి	వత్తిడితో
vattidini	కాచెలే	వత్తిడిని
vaddagala	వద్దగల	వద్దగల
vaddhagala	పివి	వద్దగల
vaddannaa	వద్దన్నా	వద్దన్నా
vaddhannaa	రుచె	వద్దన్నా
vaddae	వద్దే	వద్దే
vaddhe	వద్దే	వద్దే
vaddhee	తో	వద్దే
vadha	వధ	వధ
vanne	దా	వన్నీ
vannee	వన్నీ	వన్నీ
vannela	లేకా	వన్నెల
vayasu	వయసు	వయసు
vayasuni	విచె	వయసుని
vayasunna	వయసున్న	వయసున్న
vayasulo	తోజు	వయసులో
vayasuloe	దావి	వయసులో
vayasuloenuu	పిచె	వయసులోనూ
vayasulonu	లేరు	వయసులోనూ
varalakshamma	వరలక్ష్మమ్మ	వరలక్ష్మమ్మ
varalakshmamma	తోపినో	వరలక్ష్మమ్మ
varalaksmamma	వరలక్ష్మమ్మ	వరలక్ష్మమ్మ
varavararaavu	జుజు	వరవరరావు
varavararao	రువి	వరవరరావు
varasa	తో	వరస
varasaku	వరసకు	వరసకు
varasaga	వరసగా	వరసగా
varasagaa	వరసగా	వరసగా
varasalo	వరసలో	వరసలో
varasaloe	కా	వరసలో
varasaloo	దా	వరసలో
vargiikaranaku	వర్గీకరణకు	వర్గీకరణకు
vargiikaranhaku	రువితో	వర్గీకరణకు
vargikaranakau	వర్గీకరణకు	వర్గీకరణకు
vargiikaranaloo	వర్గీకరణలో	వర్గీకరణలో
vargiikaranhalo	లేచెరు	వర్గీకరణలో
vargiikaranhaloe	నోచెపి	వర్గీకరణలో
vargikaranalo	వర్గీకరణలో	వర్గీకరణలో
varnamaala	కాపి	వర్ణమాల
varnhamaala	వర్ణమాల	వర్ణమాల
varnhincha	వర్ణించ	వర్ణించ
varnincha	వర్ణించ	వర్ణించ
varninchadam	దాలేదా	వర్ణించడం
varninchaaru	వర్ణించారు	వర్ణించారు
varnincharu	వర్ణించారు	వర్ణించారు
varninchina	విరురు	వర్ణించిన
varnhimchaemduku	వర్ణించేందుకు	వర్ణించేందుకు
varninchendhuku	వివిరుకా	వర్ణించేందుకు
varninchenduku	వర్ణించేందుకు	వర్ణించేందుకు
vartamaanam	వర్తమానం	వర్తమానం
vartamanam	వర్తమానం	వర్తమానం
varthamaanam	నోకా	వర్తమానం
varthamanam	వర్తమానం	వర్తమానం
vartamaanaaniki	వర్తమానానికి	వర్తమానానికి
vartamananiki	కాలేజుజు	వర్తమానానికి
varthamaanaaniki	దాదాకాలే	వర్తమానానికి
varthamananiki	వర్తమానానికి	వర్తమానానికి
vartamaanaalu	పినోకా	వర్తమానాలు
vartamanalu	పివికా	వర్తమానాలు
varthamaanaalu	వర్తమానాలు	వర్తమానాలు
varthamanalu	జుతోలే	వర్తమానాలు
varshitee	పిదా	వర్శిటీ
varsiity	లేతో	వర్శిటీ
varsiti	జుదా	వర్శిటీ
varsity	చెరు	వర్శిటీ
versity	వర్శిటీ	వర్శిటీ
valachi	కా	వలచి
valasi	చె	వలసి
vashishta	జుజు	వశిష్ట
vasishta	దాకా	వశిష్ట
vasanta	కా	వసంత
vasantha	వసంత	వసంత
vasudaeva	తోకా	వసుదేవ
vasudeva	వసుదేవ	వసుదేవ
vasudaevudi	వసుదేవుడి	వసుదేవుడి
vasudevudi	వసుదేవుడి	వసుదేవుడి
vahinchaga	వహించగా	వహించగా
vahinchagaa	వివి	వహించగా
vahinchadaaniki	వహించడానికి	వహించడానికి
vahinchadaniki	వహించడానికి	వహించడానికి
vahimchaadu	వహించాడు	వహించాడు
vahinchaadu	వహించాడు	వహించాడు
vahinchadu	జువి	వహించాడు
vahimchaaru	జునో	వహించారు
vahinchaaru	వహించారు	వహించారు
vahincharu	వహించారు	వహించారు
vahimchaalani	జుకారు	వహించాలని
vahinchaalani	వహించాలని	వహించాలని
vahinchalani	వహించాలని	వహించాలని
vahimchimdhi	వహించింది	వహించింది
vahinchimdi	చెచెలే	వహించింది
vahinchindi	రుపిలే	వహించింది
vahimchina	వహించిన	వహించిన
vahinchina	వహించిన	వహించిన
vahimchinaa	నోలే	వహించినా
vahinchina	కాకా	వహించినా
vahinchinaa	కాదా	వహించినా
vahimchuta	వహించుట	వహించుట
vahinchuta	దాలే	వహించుట
vahisthondhi	పిచెరు	వహిస్తోంది
vahistondhi	దాదాపి	వహిస్తోంది
vahistoondi	వహిస్తోంది	వహిస్తోంది
vaanthulanu	వాంతులను	వాంతులను
vaantulanu	లేజు	వాంతులను
vaakyaalu	వాక్యాలు	వాక్యాలు
vaakyaalugaa	పివితో	వాక్యాలుగా
vaachmen	వాచ్మెన్	వాచ్మెన్
waatchmen	వాచ్మెన్	వాచ్మెన్
watchmen	దాతో	వాచ్మెన్
vaadini	నోలే	వాడిని
vadini	నోరు	వాడిని
vaadiyaa	వాడియా	వాడియా
vadiyaa	వాడియా	వాడియా
vaadaina	చె	వాడైన
vaadyna	కా	వాడైన
vadaina	వాడైన	వాడైన
vaanni	నోలే	వాణ్ణి
vanni	జుకా	వాణ్ణి
vaayis	చెతో	వాయిస్
voice	వాయిస్	వాయిస్
vaayisthoo	వాయిస్తూ	వాయిస్తూ
vaayisthuu	వాయిస్తూ	వాయిస్తూ
vaayistoo	చెచె	వాయిస్తూ
vayistuu	వాయిస్తూ	వాయిస్తూ
vaayuvula	రురు	వాయువుల
vayuvula	నోకా	వాయువుల
vaaranasi	కాచె	వారణాసి
varanasi	నోవి	వారణాసి
varanasilo	తోపికా	వారణాసిలో
varanasiloo	చెకాదా	వారణాసిలో
varnasiloo	వారణాసిలో	వారణాసిలో
vaarasuraaligaa	వారసురాలిగా	వారసురాలిగా
varasuraaligaa	చెకాచె	వారసురాలిగా
vaarikee	వారికీ	వారికీ
vaariki	వారికీ	వారికీ
vaariyar	వారియర్	వారియర్
waarrior	కానో	వారియర్
warior	వారియర్	వారియర్
warrior	జునో	వారియర్
vaartathoo	రురు	వార్తతో
vaartato	నోకా	వార్తతో
vaarthatho	లేపి	వార్తతో
vaartanu	నోలే	వార్తను
vaarthanu	పిదా	వార్తను
vaartala	తోనో	వార్తల
vaarthala	కాచె	వార్తల
vaartalanu	వార్తలను	వార్తలను
vaarthalanu	వార్తలను	వార్తలను
vaartaapathrika	చెలేనోతో	వార్తాపత్రిక
vaarthapathrika	జుకాదానో	వార్తాపత్రిక
vaartaapathrikaku	విదాతోకా	వార్తాపత్రికకు
vaarthapathrikaku	చెలేతోచె	వార్తాపత్రికకు
vaartaapathrikala	వితోనోజు	వార్తాపత్రికల
varthapathrikala	వికాదాజు	వార్తాపత్రికల
vaartaapathrikalu	వార్తాపత్రికలు	వార్తాపత్రికలు
varthapathrikalu	వార్తాపత్రికలు	వార్తాపత్రికలు
vaasudeeva	కాదా	వాసుదేవ
vaasudeva	పిపి	వాసుదేవ
vaasudheva	వాసుదేవ	వాసుదేవ
vaasudeevaraavu	చెదాదా	వాసుదేవరావు
vaasudevaraavu	వాసుదేవరావు	వాసుదేవరావు
vaasudhevaraavu	వాసుదేవరావు	వాసుదేవరావు
vasudevarao	విజువి	వాసుదేవరావు
vintu	పి	వింటూ
vintuu	వింటూ	వింటూ
vikalaangula	నోచెజు	వికలాంగుల
vikalangula	జుకారు	వికలాంగుల
vikalaangulu	వికలాంగులు	వికలాంగులు
vikalangulu	పితోతో	వికలాంగులు
vikalaangulaina	రునోదా	వికలాంగులైన
vikalaanguliena	వికలాంగులైన	వికలాంగులైన
vikalangulaina	పిదాదా	వికలాంగులైన
vikeendreekaranha	లేజుదారు	వికేంద్రీకరణ
vikendrikarana	వికేంద్రీకరణ	వికేంద్రీకరణ
vecky	విక్కీ	విక్కీ
vicki	రుకా	విక్కీ
vicky	లేపి	విక్కీ
vicqy	విక్కీ	విక్కీ
vikkee	జువి	విక్కీ
vikki	పికా	విక్కీ
vikky	విజు	విక్కీ
wicky	వివి	విక్కీ
victoria	విక్టోరియా	విక్టోరియా
viktooriyaa	జువినో	విక్టోరియా
viktoria	విక్టోరియా	విక్టోరియా
viktoriya	విక్టోరియా	విక్టోరియా
vijayamga	వికా	విజయంగా
vijayamgaa	దారు	విజయంగా
vijayangaa	విజయంగా	విజయంగా
vijayamu	విజయము	విజయము
vijayamulu	విజయములు	విజయములు
vijayaaniki	నోకాచె	విజయానికి
vijayaniki	రుపిజు	విజయానికి
vijayaanni	విజయాన్ని	విజయాన్ని
vijayanni	లేతోవి	విజయాన్ని
vijayaala	విజయాల	విజయాల
vijayala	నోనో	విజయాల
vijayaalatho	విజయాలతో	విజయాలతో
vijayaalathoo	తోవి	విజయాలతో
vijayaalato	విజయాలతో	విజయాలతో
vijayalato	విజయాలతో	విజయాలతో
vijayaalanu	విజయాలను	విజయాలను
vijayalanu	విజయాలను	విజయాలను
vijayudu	చెనో	విజయుడు
vijay	విజయ్	విజయ్
whistle	విజిల్	విజిల్
vithanam	విత్తనం	విత్తనం
vittanam	విత్తనం	విత్తనం
vitthanam	రుదా	విత్తనం
vithananni	విత్తనాన్ని	విత్తనాన్ని
vittananni	విత్తనాన్ని	విత్తనాన్ని
vittannanni	లేదాలే	విత్తనాన్ని
videeha	విదేహ	విదేహ
videha	విదేహ	విదేహ
vidhyaardhinii	జుకాతోచె	విద్యార్థినీ
vidyarthini	విద్యార్థినీ	విద్యార్థినీ
vidyaardhigaa	విపినోకా	విద్యార్ధిగా
vidyardhiga	విద్యార్ధిగా	విద్యార్ధిగా
vidyarthiga	దాతోనోపి	విద్యార్ధిగా
vidyaardhini	తోచెరుచె	విద్యార్ధిని
vidyardhini	లేరుతోనో	విద్యార్ధిని
vidyarthini	వికావినో	విద్యార్ధిని
vidhvamsudu	లేలేరు	విద్వాంసుడు
vidvaamsudu	విద్వాంసుడు	విద్వాంసుడు
vidvaansudu	విద్వాంసుడు	విద్వాంసుడు
vidvamsudu	పిపిజు	విద్వాంసుడు
vidhaalaa	కాచె	విధాలా
vidhala	విధాలా	విధాలా
vidhaalaina	దాలే	విధాలైన
vidhalaina	విధాలైన	విధాలైన
vinaayakudu	విదాపి	వినాయకుడి
vinayakudi	జుజుపి	వినాయకుడి
vinaayak	జుజు	వినాయక్
vinayak	వినాయక్	వినాయక్
vinaasanam	లేలే	వినాశనం
vinaashanam	వినాశనం	వినాశనం
vinasanam	జుకా	వినాశనం
vinikidi	జుజు	వినికిడి
vinimaya	వినిమయ	వినిమయ
vinoba	వినో	వినోబా
vinobaa	వినోబా	వినోబా
vinyaasam	లేనో	విన్యాసం
vinyasam	నోచె	విన్యాసం
vinyaasamlo	విన్యాసంలో	విన్యాసంలో
vinyaasanlo	నోకాలే	విన్యాసంలో
vinyasamlo	రుజులే	విన్యాసంలో
vinyasanlo	విన్యాసంలో	విన్యాసంలో
vinyaasaaniki	విన్యాసానికి	విన్యాసానికి
vinyaasaniki	విన్యాసానికి	విన్యాసానికి
vinyasaaniki	కానోజువి	విన్యాసానికి
vinyasaniki	కాపివినో	విన్యాసానికి
vinyaasaalanu	తోరుకా	విన్యాసాలను
vinyaasalanu	విజురు	విన్యాసాలను
vinyasaalanu	విన్యాసాలను	విన్యాసాలను
vinyasalanu	పితోకా	విన్యాసాలను
vipruni	విప్రుని	విప్రుని
viprulu	పిలే	విప్రులు
vibhoodhi	కారు	విభూది
vibhoodi	తోదా	విభూది
vibhudhi	చెకా	విభూది
vibhudi	పితో	విభూది
vimukthi	కాజు	విముక్తి
vimukti	నోకా	విముక్తి
virakthi	వివి	విరక్తి
virakti	విరక్తి	విరక్తి
viramana	విరమణ	విరమణ
viramanha	పి	విరమణ
viraalaala	నోతో	విరాళాల
viraalhaala	కాజు	విరాళాల
viraalaalanu	రుతోవి	విరాళాలను
viraalhaalanu	చెవిజు	విరాళాలను
viraalaalu	విరాళాలు	విరాళాలు
viraalhaalu	విరాళాలు	విరాళాలు
virigi	పికా	విరిగి
virigina	నోచె	విరిగిన
vivarana	వివరణ	వివరణ
vivaranha	వివరణ	వివరణ
vivarananu	నోలే	వివరణను
vivaranhanu	రుజు	వివరణను
vivaranala	వివరణల	వివరణల
vivaranhala	వివరణల	వివరణల
vivaranalato	వివరణలతో	వివరణలతో
vivaranhalatoe	వివరణలతో	వివరణలతో
vivaranalu	విలే	వివరణలు
vivaranhalu	చెలే	వివరణలు
vivaranalo	చెవి	వివరణలో
vivaranhaloe	వివరణలో	వివరణలో
vivaraalu	వివరాలు	వివరాలు
vivaralu	వివరాలు	వివరాలు
vishishta	తోజు	విశిష్ఠ
visishta	విశిష్ఠ	విశిష్ఠ
vishvadaanhiraama	విశ్వదాభిరామ	విశ్వదాభిరామ
vishwadhaabhiraama	తోచెవితో	విశ్వదాభిరామ
viswadaabhiraama	దాలేతోతో	విశ్వదాభిరామ
vishvasaniiya	విశ్వసనీయ	విశ్వసనీయ
vishwasaneeya	విశ్వసనీయ	విశ్వసనీయ
viswasaniiya	వివివి	విశ్వసనీయ
vishvasaniiyanga	విశ్వసనీయంగా	విశ్వసనీయంగా
vishwasaneeyangaa	పిలేజుజు	విశ్వసనీయంగా
viswasaniiyamgaa	విశ్వసనీయంగా	విశ్వసనీయంగా
vishvasaniiyata	విశ్వసనీయత	విశ్వసనీయత
vishwasaneeyatha	పితోదా	విశ్వసనీయత
visvasaniiyata	విశ్వసనీయత	విశ్వసనీయత
viswasaniiyata	విశ్వసనీయత	విశ్వసనీయత
vishvaasa	పిపి	విశ్వాస
viswaasa	దాచె	విశ్వాస
vishvaasaanni	లేతోలేకా	విశ్వాసాన్ని
viswaasaanni	తోలేపిరు	విశ్వాసాన్ని
vishvaasaala	కాజులే	విశ్వాసాల
viswaasaala	కాతోవి	విశ్వాసాల
vishvaasaalaku	విశ్వాసాలకు	విశ్వాసాలకు
viswaasaalaku	రుకాపి	విశ్వాసాలకు
vishwaasaalanu	విశ్వాసాలను	విశ్వాసాలను
viswaasaalanu	కానోతో	విశ్వాసాలను
vishapooritha	వికా	విషపూరిత
vishapuritha	తోచె	విషపూరిత
vishapuuritha	విషపూరిత	విషపూరిత
vishnuh	విజు	విష్ణుః
vishnuhu	జువి	విష్ణుః
vishnhuvu	విష్ణువు	విష్ణువు
vishnuvu	విలే	విష్ణువు
vishnhuvuku	తోదాదా	విష్ణువుకు
vishnuvuku	రుతోనో	విష్ణువుకు
vishnhuvunu	విష్ణువును	విష్ణువును
vishnuvunu	విష్ణువును	విష్ణువును
visugu	నోపి	విసుగు
viskee	విస్కీ	విస్కీ
viskii	విస్కీ	విస్కీ
whiiskey	విరు	విస్కీ
whiisky	చెరు	విస్కీ
whiskei	విస్కీ	విస్కీ
whiskey	విస్కీ	విస్కీ
whiski	నోపి	విస్కీ
whisky	లేకా	విస్కీ
whisqey	విస్కీ	విస్కీ
whisqy	లేనో	విస్కీ
vistarimpa	పిదాదా	విస్తరింప
vistarinpa	విస్తరింప	విస్తరింప
vistharimpa	కారుజు	విస్తరింప
veeriddarinee	తోజువి	వీరిద్దరినీ
veeriddharinee	లేరుపి	వీరిద్దరినీ
viiriddarinii	చెనోదా	వీరిద్దరినీ
vear	రు	వీర్
veer	చె	వీర్
viir	వీర్	వీర్
vir	లే	వీర్
weiir	వి	వీర్
weir	వి	వీర్
veellhu	నోచె	వీళ్ళు
veellu	తోపి	వీళ్ళు
viilhlhu	నోవి	వీళ్ళు
weavar	వీవర్	వీవర్
weaver	జు	వీవర్
wever	వీవర్	వీవర్
vumtaayi	రుదా	వుంటాయి
vuntaayi	వుంటాయి	వుంటాయి
vootam	నో	వూతం
vuutam	వూతం	వూతం
vruthakara	తోరుతో	వృత్తాకార
vrutthaakaara	జుకాతో	వృత్తాకార
vrutthakara	జువినో	వృత్తాకార
vruthakaramlo	నోచెనోనో	వృత్తాకారంలో
vrutthaakaaramloo	వృత్తాకారంలో	వృత్తాకారంలో
vrutthakaramlo	రుపినోకా	వృత్తాకారంలో
vennumuka	దాదాజు	వెన్నుముక
veluparinchina	వెలువరించిన	వెలువరించిన
veluvarinchina	చెరురు	వెలువరించిన
velhtaaru	వెళ్తారు	వెళ్తారు
veltaaru	దాదా	వెళ్తారు
veltharu	రుతో	వెళ్తారు
velhtundagaa	వెళ్తుండగా	వెళ్తుండగా
velthundaga	వెళ్తుండగా	వెళ్తుండగా
veltundaga	నోనోతో	వెళ్తుండగా
vellaaka	దాపి	వెళ్ళాక
vellaka	వెళ్ళాక	వెళ్ళాక
vaenkatasaastri	వేంకటశాస్త్రి	వేంకటశాస్త్రి
venkatasastri	వేంకటశాస్త్రి	వేంకటశాస్త్రి
venkatashastri	వేంకటశాస్త్రి	వేంకటశాస్త్రి
veek	వేక్	వేక్
vek	తో	వేక్
wake	చె	వేక్
wek	వేక్	వేక్
weyk	లే	వేక్
vaetakai	వేటకై	వేటకై
vetakai	రు	వేటకై
vaethanam	వేతనం	వేతనం
veethanam	వి	వేతనం
vetanam	నో	వేతనం
vaedamu	వేదము	వేదము
vedamu	వేదము	వేదము
vaedamunu	నోజు	వేదమును
vedamunu	వేదమును	వేదమును
vain	చె	వేన్
vaine	తో	వేన్
vane	వేన్	వేన్
vein	రు	వేన్
wane	నో	వేన్
wayne	వేన్	వేన్
wen	పి	వేన్
vaemula	రు	వేముల
vemula	పి	వేముల
vaerlanu	నోలే	వేర్లను
verlanu	కాతో	వేర్లను
veasadu	వేసాడు	వేసాడు
vesaadu	లేవి	వేసాడు
vesaaraa	వేసారా	వేసారా
vesara	రుతో	వేసారా
vaysaru	వేసారు	వేసారు
vesaaru	తోవి	వేసారు
vesaru	కాకా	వేసారు
vaijayamtii	జురు	వైజయంతీ
vaijayantee	వైజయంతీ	వైజయంతీ
vaijayanti	వైజయంతీ	వైజయంతీ
vaijayantii	నోజు	వైజయంతీ
vyjayantii	దాతో	వైజయంతీ
vaidhyam	వైద్యం	వైద్యం
vaidyam	లేదా	వైద్యం
vydyam	లేపి	వైద్యం
vaidhyamlo	రుజు	వైద్యంలో
vaidyamlo	వివి	వైద్యంలో
vydyamlo	జుపి	వైద్యంలో
vaivaswata	రురు	వైవస్వత
vaivaswatha	వైవస్వత	వైవస్వత
viavasvatha	వైవస్వత	వైవస్వత
vyvaswatha	వైవస్వత	వైవస్వత
votti	దానో	వొట్టి
vyaktula	వ్యక్తుల	వ్యక్తుల
vyaktulaki	వ్యక్తులకి	వ్యక్తులకి
vyaktulatho	వ్యక్తులతో	వ్యక్తులతో
vyaktulato	చెవిదా	వ్యక్తులతో
vyakthulanu	నోవిజు	వ్యక్తులను
vyaktulanu	వ్యక్తులను	వ్యక్తులను
vyaktulae	వికాదా	వ్యక్తులే
vyaktule	వ్యక్తులే	వ్యక్తులే
vyathyasam	కావితో	వ్యత్యాసం
vyatyaasam	కాతోకా	వ్యత్యాసం
vyatyasam	వ్యత్యాసం	వ్యత్యాసం
vyatyaasaalanu	తోతోపిపి	వ్యత్యాసాలను
vyatyasalanu	వ్యత్యాసాలను	వ్యత్యాసాలను
vyatyaasaalu	జుతోతో	వ్యత్యాసాలు
vyatyasalu	వ్యత్యాసాలు	వ్యత్యాసాలు
vyavaharinchae	వ్యవహరించే	వ్యవహరించే
vyavaharinche	కారురు	వ్యవహరించే
vyavaharinchaevaru	వ్యవహరించేవారు	వ్యవహరించేవారు
vyavaharinchevaaru	నోపిదాలే	వ్యవహరించేవారు
vyasanamga	జుదా	వ్యసనంగా
vyasanamgaa	నోనో	వ్యసనంగా
vyasanaanni	తోకాచె	వ్యసనాన్ని
vyasananni	నోజువి	వ్యసనాన్ని
van	లేలే	వ్యాన్
vyaan	వ్యాన్	వ్యాన్
vyaas	లేపి	వ్యాస్
vyas	వ్యాస్	వ్యాస్
vraasaadu	లేనో	వ్రాసాడు
vraasaaru	చెవి	వ్రాసారు
vraasimdi	వ్రాసింది	వ్రాసింది
vraasindi	జురునో	వ్రాసింది
vraasenu	వ్రాసెను	వ్రాసెను
vrelaada	జుతో	వ్రేలాడ
vrelaade	జునో	వ్రేలాడే
satakam	కా	శతకం
shathakam	చె	శతకం
sabari	కా	శబరి
shabari	నో	శబరి
sabdam	శబ్దం	శబ్దం
shabdam	దా	శబ్దం
sarat	చె	శరత్
sharat	శరత్	శరత్
sharath	శరత్	శరత్
sareeramloki	శరీరంలోకి	శరీరంలోకి
sareeramlooki	కాపిరు	శరీరంలోకి
sariiramloeki	పివిజు	శరీరంలోకి
sareeramloni	శరీరంలోని	శరీరంలోని
sareeramlooni	శరీరంలోని	శరీరంలోని
sariiramloeni	కాలేజు	శరీరంలోని
sariramlooni	శరీరంలోని	శరీరంలోని
shashi	రు	శశి
sastrachikitsanu	తోపిచెజుతో	శస్త్రచికిత్సను
shasthrachikithsanu	శస్త్రచికిత్సను	శస్త్రచికిత్సను
shastrachikitsanu	శస్త్రచికిత్సను	శస్త్రచికిత్సను
shstrachikitsanu	పితోపిరుకా	శస్త్రచికిత్సను
sastrachikitsalu	పికాకావివి	శస్త్రచికిత్సలు
shasthrachikithsalu	శస్త్రచికిత్సలు	శస్త్రచికిత్సలు
shastrachikitsalu	లేదాచెరుజు	శస్త్రచికిత్సలు
shstrachikitsalu	పితోవిపినో	శస్త్రచికిత్సలు
sastrachikitsaloe	జువిదాచెపి	శస్త్రచికిత్సలో
shasthrachikithsalo	శస్త్రచికిత్సలో	శస్త్రచికిత్సలో
shastrachikitsalo	దాదానోనోదా	శస్త్రచికిత్సలో
shstrachikitsalo	జువికాకాచె	శస్త్రచికిత్సలో
saasanasabhaa	వివి	శాసనసభా
shaasanasabhaa	కానో	శాసనసభా
sastravetta	శాస్త్రవేత్త	శాస్త్రవేత్త
shaasthravettha	శాస్త్రవేత్త	శాస్త్రవేత్త
shaastraveettha	శాస్త్రవేత్త	శాస్త్రవేత్త
shaastravetta	శాస్త్రవేత్త	శాస్త్రవేత్త
sastravettagaa	చెజుచెదా	శాస్త్రవేత్తగా
shaasthravetthagaa	విలేపితో	శాస్త్రవేత్తగా
shaastraveetthagaa	శాస్త్రవేత్తగా	శాస్త్రవేత్తగా
shaastravettagaa	కానోపిచె	శాస్త్రవేత్తగా
saastravettalatoo	శాస్త్రవేత్తలతో	శాస్త్రవేత్తలతో
shaasthravetthalatho	చెతోకాలేపి	శాస్త్రవేత్తలతో
shaastraveetthalathoo	శాస్త్రవేత్తలతో	శాస్త్రవేత్తలతో
shaastravettalato	కావిచెలేపి	శాస్త్రవేత్తలతో
sastravettalu	వినోలేపి	శాస్త్రవేత్తలు
shaasthravetthalu	శాస్త్రవేత్తలు	శాస్త్రవేత్తలు
shaastraveetthalu	శాస్త్రవేత్తలు	శాస్త్రవేత్తలు
shaastravettalu	రుదావినో	శాస్త్రవేత్తలు
sastraalaku	శాస్త్రాలకు	శాస్త్రాలకు
shaasthraalaku	శాస్త్రాలకు	శాస్త్రాలకు
shaastraalaku	శాస్త్రాలకు	శాస్త్రాలకు
saastraalanu	నోకాలే	శాస్త్రాలను
shaasthraalanu	శాస్త్రాలను	శాస్త్రాలను
shaastraalanu	తోచెజు	శాస్త్రాలను
sikshanaku	శిక్షణకు	శిక్షణకు
sikshanhaku	శిక్షణకు	శిక్షణకు
sikshanato	తోదా	శిక్షణతో
sikshanhatoe	జువి	శిక్షణతో
shiksanaa	పిదా	శిక్షణా
sikshanhaa	విదా	శిక్షణా
sikshnhaa	కాదా	శిక్షణా
shikharaagra	జుజు	శిఖరాగ్ర
sikharaagra	రుచె	శిఖరాగ్ర
shirasa	చె	శిరసా
sirasaa	రు	శిరసా
shilaayugam	విరు	శిలాయుగం
silaayugam	విపి	శిలాయుగం
shileendraalu	శిలీంద్రాలు	శిలీంద్రాలు
sileendraalu	శిలీంద్రాలు	శిలీంద్రాలు
siliimdraalu	దాలేతో	శిలీంద్రాలు
siliindraalu	పివిపి	శిలీంద్రాలు
shivasenaku	కాచె	శివసేనకు
sivasaenaku	నోకా	శివసేనకు
sivasenaku	నోకా	శివసేనకు
shivaa	శివా	శివా
sivaa	శివా	శివా
shivunipai	లేకా	శివునిపై
sheenu	నో	శీను
siinu	జు	శీను
sinu	రు	శీను
sheershika	శీర్షిక	శీర్షిక
shirshika	పితో	శీర్షిక
sirshika	తోపి	శీర్షిక
sheershikaku	చెపిజు	శీర్షికకు
shirshikaku	శీర్షికకు	శీర్షికకు
sirshikaku	శీర్షికకు	శీర్షికకు
sheershikatho	చెచెచె	శీర్షికతో
sheershikathoo	దావినో	శీర్షికతో
shirshikatho	జుజుదా	శీర్షికతో
sirshikato	శీర్షికతో	శీర్షికతో
sheershikana	శీర్షికన	శీర్షికన
shirshikana	శీర్షికన	శీర్షికన
sirshkana	వివి	శీర్షికన
sheershikanu	తోరులే	శీర్షికను
shirshikanu	శీర్షికను	శీర్షికను
sirshikanu	శీర్షికను	శీర్షికను
sheershikalo	నోలేతో	శీర్షికలో
sheershikaloo	శీర్షికలో	శీర్షికలో
shirshikalo	దాలేతో	శీర్షికలో
sirshikalo	శీర్షికలో	శీర్షికలో
shuddhi	వికా	శుద్ధి
shuddi	పిచె	శుద్ధి
suddhi	శుద్ధి	శుద్ధి
shuddhiga	శుద్ధిగా	శుద్ధిగా
shuddiga	శుద్ధిగా	శుద్ధిగా
suddhiga	పిలే	శుద్ధిగా
shoora	శూర	శూర
shura	రు	శూర
suura	నో	శూర
saekhara	పి	శేఖర
shekhara	శేఖర	శేఖర
shaeshayya	శేషయ్య	శేషయ్య
shesayya	రునో	శేషయ్య
sheshayya	నోనో	శేషయ్య
sobha	నో	శోభ
soobha	పి	శోభ
shobhanu	చె	శోభను
sobhanu	చె	శోభను
shobhan	శోభన్	శోభన్
sobhan	శోభన్	శోభన్
shourya	శౌర్య	శౌర్య
shmashaanavaatika	రులేపి	శ్మశానవాటిక
shmashanavatika	శ్మశానవాటిక	శ్మశానవాటిక
shmashaanavaatikalo	శ్మశానవాటికలో	శ్మశానవాటికలో
shmashanavatikalo	శ్మశానవాటికలో	శ్మశానవాటికలో
shyamala	విచె	శ్యామల
shree	శ్రీ	శ్రీ
shreemahavishnuvu	పినోతోలేకా	శ్రీమహావిష్ణువు
srimahavishnuvu	శ్రీమహావిష్ణువు	శ్రీమహావిష్ణువు
shreevaaru	శ్రీవారు	శ్రీవారు
sreevaaru	రుతో	శ్రీవారు
srivaaru	శ్రీవారు	శ్రీవారు
shruthi	శ్రుతి	శ్రుతి
sruthi	జువి	శ్రుతి
sruti	నోదా	శ్రుతి
shreyobhilaashi	చెవికాపి	శ్రేయోభిలాషి
sreyobhilaashi	చెచెపినో	శ్రేయోభిలాషి
sroeyoebhilaashi	లేదాదాకా	శ్రేయోభిలాషి
shabbir	లేరు	షబ్బీర్
shubbir	లేపి	షబ్బీర్
sharbat	షర్బత్	షర్బత్
sherbet	రుకా	షర్బత్
shrbath	చెనో	షర్బత్
sheley	షెల్లీ	షెల్లీ
shellee	కారు	షెల్లీ
shellei	షెల్లీ	షెల్లీ
shelley	లేదా	షెల్లీ
shelli	షెల్లీ	షెల్లీ
shelly	జులే	షెల్లీ
shely	దాపి	షెల్లీ
shaeru	షేరు	షేరు
sharu	పి	షేరు
sheru	లే	షేరు
sankshaemam	కాతో	సంక్షేమం
sankshemam	పితో	సంక్షేమం
sankshobha	రుకా	సంక్షోభ
sankshoebha	జుకా	సంక్షోభ
sankshobhaaniki	సంక్షోభానికి	సంక్షోభానికి
sankshobhaniki	లేజుతోవి	సంక్షోభానికి
sankshoebhaaniki	సంక్షోభానికి	సంక్షోభానికి
sankshobhaanni	సంక్షోభాన్ని	సంక్షోభాన్ని
sankshobhanni	సంక్షోభాన్ని	సంక్షోభాన్ని
sankshoebhaanni	సంక్షోభాన్ని	సంక్షోభాన్ని
sanghaaniki	లేపి	సంఘానికి
sanghaniki	సంఘానికి	సంఘానికి
samchaara	సంచార	సంచార
sanchaara	నో	సంచార
samchaaramu	సంచారము	సంచారము
sanchaaramu	విరు	సంచారము
samchaari	దాకా	సంచారి
sanchaari	సంచారి	సంచారి
samchikaku	సంచికకు	సంచికకు
sanchikaku	రుపి	సంచికకు
samchikanu	సంచికను	సంచికను
sanchikanu	సంచికను	సంచికను
samchikaloo	సంచికలో	సంచికలో
sanchikalo	రువి	సంచికలో
sanchikaloo	చెచె	సంచికలో
santhaanamga	పితో	సంతానంగా
santhanamga	పిచె	సంతానంగా
santhushtudai	లేనోనో	సంతుష్టుడై
santhustudai	చెతోచె	సంతుష్టుడై
sandarbhamuga	దాచెపి	సందర్భముగా
sandharbhamugaa	లేలేజు	సందర్భముగా
sandarbhamuna	సందర్భమున	సందర్భమున
sandharbhamuna	రుకాదా	సందర్భమున
sandarbhamulalo	సందర్భములలో	సందర్భములలో
sandharbhamulalo	తోచెజు	సందర్భములలో
sandarbhamulo	సందర్భములో	సందర్భములో
sandharbhamulo	సందర్భములో	సందర్భములో
sandhaana	రు	సంధాన
sandhana	సంధాన	సంధాన
sampadana	సంపాదన	సంపాదన
samputaalu	విజు	సంపుటాలు
samputalu	సంపుటాలు	సంపుటాలు
sampuutaalu	సంపుటాలు	సంపుటాలు
sambhaashanala	సంభాషణల	సంభాషణల
sambhaashanhala	సంభాషణల	సంభాషణల
sambhashanala	సంభాషణల	సంభాషణల
sambhaashanhalaku	సంభాషణలకు	సంభాషణలకు
sambhashanalaku	సంభాషణలకు	సంభాషణలకు
sambhaashanalalo	పివికా	సంభాషణలలో
sambhaashanhalaloo	సంభాషణలలో	సంభాషణలలో
sambhashanalalo	కాకాకా	సంభాషణలలో
samrakshinchadaaniki	సంరక్షించడానికి	సంరక్షించడానికి
samrakshinchadaniki	రులేదాపిదా	సంరక్షించడానికి
samrakshinchabadina	సంరక్షించబడిన	సంరక్షించబడిన
samrakshinche	జుచెదా	సంరక్షించే
samrakshinchee	సంరక్షించే	సంరక్షించే
samsad	సంసద్	సంసద్
samsadh	తో	సంసద్
sakramamga	సక్రమంగా	సక్రమంగా
sakramamgaa	సక్రమంగా	సక్రమంగా
sakramaina	పిలే	సక్రమమైన
sakramamaina	రుదా	సక్రమమైన
success	సక్సెస్	సక్సెస్
successes	సక్సెస్	సక్సెస్
sukcess	తోజు	సక్సెస్
sakhee	జు	సఖీ
sakhi	సఖీ	సఖీ
sagamlo	సగంలో	సగంలో
sagamloo	వి	సగంలో
sachivaalayam	జుచె	సచివాలయం
sathyamgaa	జునో	సత్యంగా
satyangaa	సత్యంగా	సత్యంగా
sathyamunaku	సత్యమునకు	సత్యమునకు
satyamunaku	విచెతో	సత్యమునకు
sathyamoorthi	పినోవి	సత్యమూర్తి
sathyamuurthi	సత్యమూర్తి	సత్యమూర్తి
satyamoorti	పిజుచె	సత్యమూర్తి
satyamuurti	సత్యమూర్తి	సత్యమూర్తి
sathyaagraha	రుదాదా	సత్యాగ్రహ
satyaagraha	సత్యాగ్రహ	సత్యాగ్రహ
satyagraha	లేనోరు	సత్యాగ్రహ
setyagraha	రుజువి	సత్యాగ్రహ
sathyaagraham	నోదాచె	సత్యాగ్రహం
satyaagraham	సత్యాగ్రహం	సత్యాగ్రహం
satyagraham	చెపిజు	సత్యాగ్రహం
satyaagrahanni	సత్యాగ్రహాన్ని	సత్యాగ్రహాన్ని
satyagrahanni	రుకాపిజు	సత్యాగ్రహాన్ని
satyaanne	దాజువి	సత్యాన్ని
satyaanni	దాతోలే	సత్యాన్ని
satyanni	వినోరు	సత్యాన్ని
satyaalu	తోవి	సత్యాలు
satyalu	సత్యాలు	సత్యాలు
sadaru	సదరు	సదరు
sadharu	సదరు	సదరు
sadaananda	చెపి	సదానంద
sadhaanamdha	సదానంద	సదానంద
sadhaanandha	సదానంద	సదానంద
sannaahaalu	సన్నాహాలు	సన్నాహాలు
sannahalu	సన్నాహాలు	సన్నాహాలు
sanniveesha	లేదా	సన్నివేశ
sannivesa	సన్నివేశ	సన్నివేశ
sannivesha	కాదా	సన్నివేశ
sanniveesham	చెకానో	సన్నివేశం
sannivesam	సన్నివేశం	సన్నివేశం
sannivesham	సన్నివేశం	సన్నివేశం
sanniveeshamthoo	నోకాలే	సన్నివేశంతో
sannivesamto	సన్నివేశంతో	సన్నివేశంతో
sanniveshamto	సన్నివేశంతో	సన్నివేశంతో
sanniveeshaanni	జువిపినో	సన్నివేశాన్ని
sanniveshaanni	రుపిపికా	సన్నివేశాన్ని
sannivaesaalloe	జురునోతో	సన్నివేశాల్లో
sanniveshaallo	సన్నివేశాల్లో	సన్నివేశాల్లో
sabhalanu	లే	సభలను
sabhallo	సభల్లో	సభల్లో
sabhalloo	విదా	సభల్లో
sabhyudigaa	పిదాలే	సభ్యుడిగా
sabhyuni	సభ్యుని	సభ్యుని
sabhyunigaa	లేలేరు	సభ్యునిగా
samakurchadu	నోజుపి	సమకూర్చాడు
samakuurchaadu	సమకూర్చాడు	సమకూర్చాడు
samakuurchadu	చెనోకా	సమకూర్చాడు
samakuurchindi	కాతోపి	సమకూర్చింది
samkurchindi	పిరుతో	సమకూర్చింది
samarpana	సమర్పణ	సమర్పణ
samarpanalu	సమర్పణలు	సమర్పణలు
samarpinchiri	సమర్పించిరి	సమర్పించిరి
samaachaaramthoo	తోకాతో	సమాచారంతో
samaachaaramto	లేలేజు	సమాచారంతో
samaachaaramlo	తోతోతో	సమాచారంలో
samaachaaramloo	సమాచారంలో	సమాచారంలో
samaacharamlo	వినోనో	సమాచారంలో
samaachaaramloni	సమాచారంలోని	సమాచారంలోని
samaachaaramlooni	లేపివి	సమాచారంలోని
samaacharamloni	పినోతో	సమాచారంలోని
samaajamae	సమాజమే	సమాజమే
samajame	సమాజమే	సమాజమే
samaadhula	సమాధుల	సమాధుల
samadhula	సమాధుల	సమాధుల
samaadhulanu	లేతో	సమాధులను
samadhulanu	సమాధులను	సమాధులను
samaasa	వి	సమాస
samasa	తో	సమాస
samithiki	సమితికి	సమితికి
samitiki	రువి	సమితికి
samithini	సమితిని	సమితిని
samitini	పిచె	సమితిని
samithiloo	దాలే	సమితిలో
samitilo	దాతో	సమితిలో
samudaayaaniki	సముదాయానికి	సముదాయానికి
samudayaniki	సముదాయానికి	సముదాయానికి
samudaayaala	నోవి	సముదాయాల
samudayala	జురు	సముదాయాల
samudaayaalaku	చెతోవి	సముదాయాలకు
samudaayaalu	లేనోపి	సముదాయాలు
samudramu	నోచె	సముద్రము
samudramulo	పిపిజు	సముద్రములో
samudramuloo	దాచెరు	సముద్రములో
saamuraai	సమురాయ్	సమురాయ్
samuraam	కావి	సమురాయ్
samuraay	సమురాయ్	సమురాయ్
samurai	సమురాయ్	సమురాయ్
samuroy	జుపి	సమురాయ్
saralamga	విచె	సరళంగా
saralamgaa	వినో	సరళంగా
saralangaa	రువి	సరళంగా
saralata	చె	సరళత
saralatha	తో	సరళత
saralamaina	సరళమైన	సరళమైన
saraasari	దాదా	సరాసరి
sarasari	రుజు	సరాసరి
sarita	లే	సరిత
saritha	సరిత	సరిత
saripada	చె	సరిపడ
saripadani	సరిపడని	సరిపడని
sarihaddulaku	సరిహద్దులకు	సరిహద్దులకు
sarihaddulalo	తోవిజు	సరిహద్దులలో
sarihaddulaloo	రుకాకా	సరిహద్దులలో
sarjari	జుజు	సర్జరీ
surgary	కావి	సర్జరీ
surgeri	తోజు	సర్జరీ
surgery	సర్జరీ	సర్జరీ
surjery	కాతో	సర్జరీ
suurgery	లేనో	సర్జరీ
sarpam	సర్పం	సర్పం
sarpanchi	సర్పంచి	సర్పంచి
sarpanchigaa	సర్పంచిగా	సర్పంచిగా
sarvamunu	జుదా	సర్వమును
sarvumunu	లేపి	సర్వమును
sarvices	రుతోనో	సర్వీసెస్
services	సర్వీసెస్	సర్వీసెస్
serviices	సర్వీసెస్	సర్వీసెస్
sarvooththama	రుచెదా	సర్వోత్తమ
sarvothama	లేచెచె	సర్వోత్తమ
sarvottama	సర్వోత్తమ	సర్వోత్తమ
sarvotthama	దారుజు	సర్వోత్తమ
saangs	విదా	సాంగ్స్
songs	సాంగ్స్	సాంగ్స్
saanghika	విపి	సాంఘిక
sanghika	సాంఘిక	సాంఘిక
saanghikamga	సాంఘికంగా	సాంఘికంగా
saanghikangaa	నోరుచె	సాంఘికంగా
sanghikamgaa	పిపివి	సాంఘికంగా
saanthvana	విదా	సాంత్వన
saantvana	సాంత్వన	సాంత్వన
saatwana	విచె	సాంత్వన
santhvana	పినో	సాంత్వన
santvana	లేకా	సాంత్వన
saakshyam	లేరు	సాక్ష్యం
sakshyam	చెచె	సాక్ష్యం
saagadaaniki	సాగడానికి	సాగడానికి
saagaalani	జునో	సాగాలని
saagutunna	సాగుతున్న	సాగుతున్న
sagutunna	సాగుతున్న	సాగుతున్న
saadhimchina	కావి	సాధించిన
saadhinchina	చెలే	సాధించిన
sadhinchina	వినో	సాధించిన
saamudrikam	సాముద్రికం	సాముద్రికం
samudrikam	సాముద్రికం	సాముద్రికం
saam	జు	సామ్
sam	నో	సామ్
saamraajyamu	సామ్రాజ్యము	సామ్రాజ్యము
saayamthram	తోకా	సాయంత్రం
saayantram	విజు	సాయంత్రం
saayamthramu	పిలేలే	సాయంత్రము
saayantramu	సాయంత్రము	సాయంత్రము
saayamthraaniki	సాయంత్రానికి	సాయంత్రానికి
saayantraaniki	సాయంత్రానికి	సాయంత్రానికి
saaradhigaa	నోజు	సారథిగా
saarathigaa	దాపి	సారథిగా
saaeadhyamloe	తోనోచె	సారధ్యంలో
saaradhyamloo	పిలేదా	సారధ్యంలో
saaramu	సారము	సారము
saarimchaadu	చెకాతో	సారించాడు
saarinchaadu	కారుపి	సారించాడు
saarimchaaru	కాకాకా	సారించారు
saarinchaaru	తోకానో	సారించారు
saarimchimdhi	రువిరు	సారించింది
saarinchindi	నోదాజు	సారించింది
saare	సారె	సారె
saalid	జునో	సాలిడ్
salid	సాలిడ్	సాలిడ్
solid	పిచె	సాలిడ్
saavadhaanamgaa	లేనోరు	సావధానంగా
saavadhaanangaa	సావధానంగా	సావధానంగా
saasar	సాసర్	సాసర్
saaucer	సాసర్	సాసర్
saucar	చె	సాసర్
saucer	వి	సాసర్
sauucer	లే	సాసర్
saahasi	సాహసి	సాహసి
simgana	లే	సింగన
singana	నో	సింగన
sidhu	పి	సింగ్
sing	జు	సింగ్
singh	సింగ్	సింగ్
sikander	సికిందర్	సికిందర్
sikimdar	సికిందర్	సికిందర్
sikindar	సికిందర్	సికిందర్
siddantamu	దాచెతో	సిద్ధాంతము
siddhaamtamu	తోజుజు	సిద్ధాంతము
siddhaantamu	పిదాలే	సిద్ధాంతము
siddaantamunu	తోజులేదా	సిద్ధాంతమును
siddhaamtamunu	సిద్ధాంతమును	సిద్ధాంతమును
siddhaantamunu	విచెకాదా	సిద్ధాంతమును
sira	సిరా	సిరా
siraa	నో	సిరా
seejanlo	పిలే	సీజన్లో
siijanloo	తోతో	సీజన్లో
sijanlo	రుకా	సీజన్లో
seethaaraamayya	సీతారామయ్య	సీతారామయ్య
siitaramayya	చెతోపి	సీతారామయ్య
sitaramaya	సీతారామయ్య	సీతారామయ్య
suprabhaata	కానో	సుప్రభాత
suprabhaatha	సుప్రభాత	సుప్రభాత
suprabhatha	కాజు	సుప్రభాత
subbanna	సుబ్బన్న	సుబ్బన్న
subbaraaju	దాపిచె	సుబ్బరాజు
subbaraju	రుపితో	సుబ్బరాజు
subbaaraavugaaru	జులేదాలే	సుబ్బారావుగారు
subbaaraavuni	సుబ్బారావుని	సుబ్బారావుని
subbaaravyni	దావివివి	సుబ్బారావుని
surabhi	కా	సురభి
suraes	తోపి	సురేశ్
suresh	సురేశ్	సురేశ్
sulabha	దా	సులభ
sultaanu	తోజు	సుల్తాను
sulthaanu	సుల్తాను	సుల్తాను
sulthanu	విలే	సుల్తాను
sultaanula	సుల్తానుల	సుల్తానుల
sulthaanula	జుకావి	సుల్తానుల
sulthanula	సుల్తానుల	సుల్తానుల
sultaanulu	విపిపి	సుల్తానులు
sulthanulu	రునోవి	సుల్తానులు
suhaasini	దాపి	సుహాసిని
sookti	రుదా	సూక్తి
suukthi	దానో	సూక్తి
suukti	చెజు	సూక్తి
suchinche	విచె	సూచించే
suuchimchae	చెవి	సూచించే
suuchinchae	జుపి	సూచించే
sooryanaaraayana	విదానో	సూర్యనారాయణ
suryanaaraayana	నోపివి	సూర్యనారాయణ
suryanarayana	కాజుకా	సూర్యనారాయణ
suuryanaaraayanha	కావికా	సూర్యనారాయణ
sens	తోచె	సెన్స్
sense	పిలే	సెన్స్
septembar	విజువి	సెప్టెంబర్
september	రునోదా	సెప్టెంబర్
saekarinchaaru	వివిపి	సేకరించారు
sekarinchaaru	దాపితో	సేకరించారు
sekrinchaaru	రువిలే	సేకరించారు
saekarinchina	సేకరించిన	సేకరించిన
sekarinchina	సేకరించిన	సేకరించిన
saen	సేన్	సేన్
sane	సేన్	సేన్
seen	సేన్	సేన్
sen	లే	సేన్
sevalandincharu	సేవలందించారు	సేవలందించారు
sevalandinche	కాకారు	సేవలందించే
cycle	సైకిల్	సైకిల్
cykil	సైకిల్	సైకిల్
cykle	చెరు	సైకిల్
cyqil	సైకిల్	సైకిల్
cyqle	సైకిల్	సైకిల్
saikil	కాకా	సైకిల్
saiqil	సైకిల్	సైకిల్
sekil	దాతో	సైకిల్
cycles	రునో	సైకిల్స్
saikils	సైకిల్స్	సైకిల్స్
sainas	సైనస్	సైనస్
sinas	సైనస్	సైనస్
sinus	కా	సైనస్
sainik	సైనిక్	సైనిక్
sainyamunu	సైన్యమును	సైన్యమును
sainyaaniki	చెనోపి	సైన్యానికి
sainyaniki	సైన్యానికి	సైన్యానికి
sainyaanni	తోకాలే	సైన్యాన్ని
sainyanni	నోనోరు	సైన్యాన్ని
sienyaanni	సైన్యాన్ని	సైన్యాన్ని
sainyaalaku	లేపిపి	సైన్యాలకు
sianyalaku	జునోలే	సైన్యాలకు
sienyaalaku	దాపికా	సైన్యాలకు
sainyaalato	కాపితో	సైన్యాలతో
sainyaalatoo	సైన్యాలతో	సైన్యాలతో
sainyalatho	జుకావి	సైన్యాలతో
sienyaalatoo	సైన్యాలతో	సైన్యాలతో
sainyaalanu	జుకాలే	సైన్యాలను
sainyalanu	సైన్యాలను	సైన్యాలను
sienyaalanu	సైన్యాలను	సైన్యాలను
soap	లే	సోప్
sop	సోప్	సోప్
sope	సోప్	సోప్
sofhiya	సోఫియా	సోఫియా
sofia	నోచె	సోఫియా
sofiaa	జుతో	సోఫియా
sofiya	సోఫియా	సోఫియా
sophia	సోఫియా	సోఫియా
sophiaa	సోఫియా	సోఫియా
somavaram	సోమవారం	సోమవారం
soomavaaram	జుచె	సోమవారం
somavaramu	విలే	సోమవారము
soomavaaramu	సోమవారము	సోమవారము
social	సోషల్	సోషల్
soeshal	నో	సోషల్
soshal	సోషల్	సోషల్
southaafricaa	లేచెరు	సౌతాఫ్రికా
southafrica	సౌతాఫ్రికా	సౌతాఫ్రికా
staatistics	విలేలేపి	స్టాటిస్టిక్స్
staitistics	స్టాటిస్టిక్స్	స్టాటిస్టిక్స్
statistics	స్టాటిస్టిక్స్	స్టాటిస్టిక్స్
stetistics	పిపిరుజు	స్టాటిస్టిక్స్
staanlee	నోతో	స్టాన్లీ
staanlii	లేనో	స్టాన్లీ
stanlee	జుపి	స్టాన్లీ
stanley	లేపి	స్టాన్లీ
stoodents	జులేలే	స్టూడెంట్స్
students	నోనోలే	స్టూడెంట్స్
stuudents	స్టూడెంట్స్	స్టూడెంట్స్
staem	తోరు	స్టెమ్
stem	నోజు	స్టెమ్
staraid	స్టెరాయిడ్	స్టెరాయిడ్
starayid	స్టెరాయిడ్	స్టెరాయిడ్
staroid	స్టెరాయిడ్	స్టెరాయిడ్
steraaid	కాదాలే	స్టెరాయిడ్
steraid	దావికా	స్టెరాయిడ్
sterayid	దావికా	స్టెరాయిడ్
steroid	జుదాపి	స్టెరాయిడ్
staets	స్టేట్స్	స్టేట్స్
states	రుదా	స్టేట్స్
stetes	స్టేట్స్	స్టేట్స్
stets	రులే	స్టేట్స్
strokes	స్ట్రోక్స్	స్ట్రోక్స్
stroqes	స్ట్రోక్స్	స్ట్రోక్స్
sthree	స్త్రీ	స్త్రీ
stree	దాతో	స్త్రీ
stri	తోవి	స్త్రీ
streeki	పిరు	స్త్రీకి
striki	చెతో	స్త్రీకి
sthreelantaa	పిరురు	స్త్రీలంతా
strilantaa	దాలేజు	స్త్రీలంతా
strilantha	కానోకా	స్త్రీలంతా
sdhala	కా	స్థల
sthala	స్థల	స్థల
sdhalamunaku	స్థలమునకు	స్థలమునకు
sthalamunaku	లేవిదా	స్థలమునకు
sdhalaaniki	స్థలానికి	స్థలానికి
sthalaaniki	వివినో	స్థలానికి
sdhalaanni	స్థలాన్ని	స్థలాన్ని
sthalaanni	స్థలాన్ని	స్థలాన్ని
sthithulalo	చెతోచె	స్థితులలో
sthithulaloo	నోలేచె	స్థితులలో
sthirapaddaadu	పిదావిచె	స్థిరపడ్డాడు
sthirapaddadu	స్థిరపడ్డాడు	స్థిరపడ్డాడు
sthirapaddaaru	స్థిరపడ్డారు	స్థిరపడ్డారు
sthirapaddaru	స్థిరపడ్డారు	స్థిరపడ్డారు
slooveeniyaa	స్లోవేనియా	స్లోవేనియా
sloveenia	స్లోవేనియా	స్లోవేనియా
slovenia	స్లోవేనియా	స్లోవేనియా
sloveniya	స్లోవేనియా	స్లోవేనియా
sloveniyaa	వికావి	స్లోవేనియా
swaramunu	స్వరమును	స్వరమును
svaramulu	స్వరములు	స్వరములు
swaramulu	స్వరములు	స్వరములు
svaraanni	నోదాతో	స్వరాన్ని
swaraanni	స్వరాన్ని	స్వరాన్ని
swaranni	కాపినో	స్వరాన్ని
svaraalu	నోపి	స్వరాలు
swaraalu	స్వరాలు	స్వరాలు
swaralu	తోతో	స్వరాలు
svargamla	స్వర్గంలా	స్వర్గంలా
svargamlaa	కాలేతో	స్వర్గంలా
swargamlaa	స్వర్గంలా	స్వర్గంలా
svasthalam	జులే	స్వస్థలం
swasdhalam	స్వస్థలం	స్వస్థలం
svasthalaalaku	స్వస్థలాలకు	స్వస్థలాలకు
swaasdhalaalaku	స్వస్థలాలకు	స్వస్థలాలకు
swastalaalaku	స్వస్థలాలకు	స్వస్థలాలకు
swaatantrya	స్వాతంత్య్ర	స్వాతంత్య్ర
swaatantyra	స్వాతంత్య్ర	స్వాతంత్య్ర
swaathamthram	స్వాతంత్య్ర	స్వాతంత్య్ర
swaatamtyram	దారువినో	స్వాతంత్య్రం
swaatantryam	తోనోవితో	స్వాతంత్య్రం
swaathamthrayam	నోదాతోనో	స్వాతంత్య్రం
svatantryodyama	స్వాతంత్ర్యోద్యమ	స్వాతంత్ర్యోద్యమ
swatamtryoedyama	స్వాతంత్ర్యోద్యమ	స్వాతంత్ర్యోద్యమ
swatantrypdyama	జుజుకాదావి	స్వాతంత్ర్యోద్యమ
hakkulu	హక్కులు	హక్కులు
haj	హజ్	హజ్
hajj	హజ్	హజ్
hazz	వి	హజ్
halvaa	హల్వా	హల్వా
halwa	వి	హల్వా
halwaa	దా	హల్వా
haarmoonula	హార్మోనుల	హార్మోనుల
harmonula	లేతోతో	హార్మోనుల
hormonula	హార్మోనుల	హార్మోనుల
haastal	కాపి	హాస్టల్
hastal	హాస్టల్	హాస్టల్
hostel	హాస్టల్	హాస్టల్
hip	హిప్	హిప్
heatar	హీటర్	హీటర్
heater	వి	హీటర్
heetar	తో	హీటర్
heeter	హీటర్	హీటర్
hiitar	నో	హీటర్
haroin	హీరోయిన్	హీరోయిన్
haroine	హీరోయిన్	హీరోయిన్
heeroyin	హీరోయిన్	హీరోయిన్
heroiin	హీరోయిన్	హీరోయిన్
heroiine	జురు	హీరోయిన్
heroin	కారు	హీరోయిన్
heroine	చెజు	హీరోయిన్
hiiroiine	దాతో	హీరోయిన్
hiroine	పికా	హీరోయిన్
hrudayam	హృదయం	హృదయం
hrudayamthoo	హృదయంతో	హృదయంతో
hrudayamto	నోదా	హృదయంతో
hrudayamtoo	జుపి	హృదయంతో
hrudayamlo	పిరు	హృదయంలో
hrudayamloo	నోనో	హృదయంలో
henree	జుపి	హెన్రీ
henri	లేకా	హెన్రీ
henrii	హెన్రీ	హెన్రీ
henry	హెన్రీ	హెన్రీ
helicoptar	రుతోతో	హెలికాప్టర్
helicopter	కాకాదా	హెలికాప్టర్
helikaaptar	రుకాలే	హెలికాప్టర్
helikopter	హెలికాప్టర్	హెలికాప్టర్
haethuvulu	హేతువులు	హేతువులు
haetuvulu	కాలే	హేతువులు
hethuvulu	జులే	హేతువులు
hetuvulu	హేతువులు	హేతువులు
haidarabadi	రుజుతో	హైదరాబాదీ
hydaraabaadii	హైదరాబాదీ	హైదరాబాదీ
hyderaabaadee	పివితో	హైదరాబాదీ
hyderaabaadii	హైదరాబాదీ	హైదరాబాదీ
hyderabadi	హైదరాబాదీ	హైదరాబాదీ
haiskoolulo	రురుతో	హైస్కూలులో
haiskululo	తోరుతో	హైస్కూలులో
highschoolulo	హైస్కూలులో	హైస్కూలులో